source	translated	reference
A man in an orange hat starring at something.	Một người đàn ông trong một ngôi sao màu vàng ở một cái gì đó.	Một người đàn ông đội mũ màu cam đang nhìn chằm chằm vào thứ gì đó.
A Boston Terrier is running on lush green grass in front of a white fence.	Một nhà sản xuất Boston đang chạy trên bãi cỏ xanh phía trước hàng rào trắng.	Một chú chó Boston Terrier đang chạy trên bãi cỏ xanh tươi trước hàng rào màu trắng.
A girl in karate uniform breaking a stick with a front kick.	Một cô gái mặc quân phục mặc đồng phục mặc đồng phục mặc áo bó với một cú đá trước.	Một cô gái mặc võ phục karate đang bẻ gãy một cây gậy bằng cú đá trước.
Five people wearing winter jackets and helmets stand in the snow, with snowmobiles in the background.	Năm người mặc áo khoác mùa đông và đội mũ bảo hộ đứng trên tuyết, với tuyết trượt tuyết ở phía sau.	Năm người mặc áo khoác mùa đông và mũ bảo hiểm đứng trên tuyết, phía sau là xe trượt tuyết.
People are fixing the roof of a house.	Mọi người đang sửa mái nhà.	Mọi người đang sửa mái nhà.
A man in light colored clothing photographs a group of men wearing dark suits and hats standing around a woman dressed in a strapless gown.	Một người đàn ông mặc quần áo màu sáng chụp hình một nhóm đàn ông mặc áo khoác đen và đội mũ trùm đầu một phụ nữ mặc áo choàng bó.	Một người đàn ông mặc quần áo sáng màu đang chụp ảnh một nhóm đàn ông mặc vest tối màu và đội mũ đứng xung quanh một người phụ nữ mặc váy hở vai.
A group of people standing in front of an igloo.	Một nhóm người đứng trước một iloo.	Một nhóm người đang đứng trước một túp lều tuyết.
A boy in a red uniform is attempting to avoid getting out at home plate, while the catcher in the blue uniform is attempting to catch him.	Một chàng trai mặc đồng phục màu đỏ đang cố tránh ra ngoài trong khi người mặc đồng phục mặc đồng phục đang cố bắt anh ta.	Một cậu bé mặc đồng phục màu đỏ đang cố gắng tránh ra khỏi đĩa nhà, trong khi người bắt bóng mặc đồng phục màu xanh đang cố gắng bắt cậu bé.
A guy works on a building.	Một gã làm ở tòa nhà.	Một anh chàng đang làm việc trên một tòa nhà.
A man in a vest is sitting in a chair and holding magazines.	Một người đàn ông mặc áo vest đang ngồi trên ghế và cầm tạp chí.	Một người đàn ông mặc áo vest đang ngồi trên ghế và cầm tạp chí.
A mother and her young song enjoying a beautiful day outside.	Một người mẹ và đứa con đang hát một ngày đẹp trời bên ngoài.	Một bà mẹ và đứa con nhỏ của mình đang tận hưởng một ngày đẹp trời ở bên ngoài.
Men playing volleyball, with one player missing the ball but hands still in the air.	Đàn ông chơi đùa, với một người trượt bóng nhưng tay vẫn còn trong không trung.	Những người đàn ông đang chơi bóng chuyền, có một cầu thủ mất bóng nhưng tay vẫn giơ lên ​​cao.
A woman holding a bowl of food in a kitchen.	Một người phụ nữ đang cầm một bát thức ăn trong nhà bếp.	Một người phụ nữ đang cầm bát thức ăn trong bếp.
Man sitting using tool at a table in his home.	Người đàn ông ngồi bằng cách sử dụng công cụ tại một bảng trong nhà của mình.	Người đàn ông đang ngồi sử dụng dụng cụ tại một chiếc bàn trong nhà mình.
Three people sit in a cave.	Ba người ngồi trong một cái hang.	Ba người ngồi trong một hang động.
A girl in a jean dress is walking along a raised balance beam.	Một cô gái mặc váy hồng đang bước đi trên một cái cân bằng.	Một cô gái mặc váy jean đang đi dọc theo một thanh xà thăng bằng được nâng lên.
A blond holding hands with a guy in the sand.	Một cô gái tóc vàng cầm tay với một gã trên cát.	Một cô gái tóc vàng nắm tay một chàng trai trên bãi cát.
A woman in a gray sweater and black baseball cap is standing in line at a shop.	Một người phụ nữ mặc áo len màu xám và đội mũ bóng chày đen đứng xếp hàng tại một cửa hàng.	Một người phụ nữ mặc áo len xám và mũ bóng chày đen đang đứng xếp hàng tại một cửa hàng.
The person in the striped shirt is mountain climbing.	Người mặc áo sọc là leo núi.	Người mặc áo sọc đang leo núi.
Two men pretend to be statutes while women look on.	Hai người đàn ông giả bộ trong khi phụ nữ nhìn vào.	Hai người đàn ông giả vờ làm tượng trong khi những người phụ nữ đứng nhìn.
People standing outside of a building.	Những người đứng bên ngoài tòa nhà.	Mọi người đứng bên ngoài tòa nhà.
A teenager plays her trumpet on the field at a game.	Một thiếu niên thổi kèn trên sân trong một trò chơi.	Một thiếu nữ đang chơi kèn trumpet trên sân trong một trận đấu.
A woman does a somersault on a trampoline on the beach.	Một người phụ nữ làm một cái bẫy trên bãi biển.	Một người phụ nữ đang lộn nhào trên tấm bạt lò xo trên bãi biển.
A man is standing by a group of video games in a bar.	Một người đàn ông đang đứng cạnh một nhóm trò chơi điện tử trong một quán bar.	Một người đàn ông đang đứng cạnh một nhóm trò chơi điện tử trong quán bar.
A woman uses a drill while another man takes her picture.	Một phụ nữ luyện tập trong khi một người đàn ông khác chụp ảnh cô ấy.	Một người phụ nữ sử dụng máy khoan trong khi một người đàn ông khác chụp ảnh cô ấy.
A woman in a pink sweater and an apron, cleaning a table with a sponge.	Một người phụ nữ mặc áo len màu hồng và một cái băng dính, dọn dẹp một cái bàn với một cái bàn cao su.	Một người phụ nữ mặc áo len hồng và tạp dề, đang lau bàn bằng miếng bọt biển.
A man cutting branches of trees.	Một người cắt tỉa những nhánh cây.	Một người đàn ông đang cắt cành cây.
Group of Asian boys wait for meat to cook over barbecue.	Một đám nhóc Châu Á đang chờ thịt để ăn thịt nướng.	Một nhóm thanh niên châu Á đang chờ thịt nướng chín.
Women, wearing traditional clothing, are reenacting native life.	Phụ nữ, mặc quần áo truyền thống, đang biến đổi cuộc sống của người bản xứ.	Những người phụ nữ mặc trang phục truyền thống đang tái hiện cuộc sống bản địa.
One man holds another man's head down and prepares to punch him in the face.	Người này cúi đầu xuống và chuẩn bị đấm vào mặt người kia.	Một người đàn ông giữ đầu một người đàn ông khác xuống và chuẩn bị đấm vào mặt anh ta.
Six people ride mountain bikes through a jungle environment.	Sáu người leo núi xuyên qua một khu rừng.	Sáu người đạp xe leo núi xuyên qua môi trường rừng rậm.
2 blond girls are sitting on a ledge in a crowded plaza.	2 cô gái tóc vàng đang ngồi trên một tảng đá trong một đám đông.	2 cô gái tóc vàng đang ngồi trên bệ đá ở một quảng trường đông đúc.
A child is splashing in the water	♪ Một em bé vừa nhỏ vừa nhỏ vừa chảy nước ♪	Một đứa trẻ đang té nước
Three people sit at a picnic table outside of a building painted like a union jack.	Ba người ngồi trên bàn ăn ngoài một tòa nhà được vẽ như một quán rượu.	Ba người ngồi ở một chiếc bàn dã ngoại bên ngoài một tòa nhà được sơn giống lá cờ Liên hiệp Vương quốc Anh.
3 boys are standing on a pier in their bathing suits.	3 thằng con trai đang đứng trên 1 con tàu trong bộ đồ hóa trang.	3 cậu bé đang đứng trên cầu tàu trong bộ đồ bơi.
An employee is handing a woman a bag while she is browsing through fish on ice at a street market.	Một nhân viên đang đưa cho một phụ nữ một túi trong khi cô ấy đang băng qua băng trên đường phố.	Một nhân viên đang đưa cho một người phụ nữ một chiếc túi khi cô ấy đang xem cá đông lạnh ở một khu chợ đường phố.
A pretty woman plays a harpsichord.	Một phụ nữ xinh đẹp chơi đàn hạc.	Một người phụ nữ xinh đẹp đang chơi đàn harpsichord.
Outside a building, a uniformed security guard looks at the camera from behind a fence.	Bên ngoài một tòa nhà, một bảo vệ đồng phục nhìn vào camera từ phía sau hàng rào.	Bên ngoài tòa nhà, một nhân viên bảo vệ mặc đồng phục đang nhìn vào camera từ phía sau hàng rào.
The young lady is looking at the pizza.	Cô gái đang nhìn vào pizza.	Cô gái trẻ đang nhìn vào chiếc bánh pizza.
A shirtless man in shorts is fishing while standing on some rocks.	Một người đàn ông không mặc quần đùi đang đứng trên một số tảng đá.	Một người đàn ông cởi trần, mặc quần short đang câu cá trong khi đứng trên một tảng đá.
A girl wearing a life vest floats in water.	Một cô gái mặc áo phao trong nước.	Một cô gái mặc áo phao đang nổi trên mặt nước.
A man in uniform and a man in a blue shirt are standing in front of a truck.	Một người mặc đồng phục và một người mặc áo xanh đang đứng trước một chiếc xe tải.	Một người đàn ông mặc đồng phục và một người đàn ông mặc áo sơ mi xanh đang đứng trước một chiếc xe tải.
People sit inside a train.	Mọi người ngồi bên trong một con tàu.	Mọi người ngồi bên trong tàu hỏa.
A kid swings with his feet up in the air in a forest.	Một thằng nhóc đu đưa với đôi chân lên trời trong một khu rừng.	Một đứa trẻ đang đu mình với đôi chân giơ lên ​​cao trong không trung ở trong rừng.
A man in a red shirt entering an establishment.	Một người đàn ông mặc áo sơ-mi mặc đồng phục.	Một người đàn ông mặc áo sơ mi đỏ bước vào một cơ sở.
Two men wearing swim trunks jump in the air at a moderately populated beach.	Hai người đàn ông mặc quần bơi nhảy vào không khí ở bãi biển trung bình.	Hai người đàn ông mặc quần bơi nhảy lên không trung tại một bãi biển có lượng người dân vừa phải.
A toddler is cooking with another person.	Một người đang giao tiếp với người khác.	Một đứa trẻ đang nấu ăn cùng một người khác.
A father-figure and two children outside their home doing yard work such as using a hoe on the grass and planting a tree.	Một người cha-người cha và hai đứa trẻ bên ngoài nhà làm việc vườn như bằng cách sử dụng một cây kim trên cỏ và một cây trồng.	Một người cha và hai đứa con đang làm việc ngoài sân nhà mình như dùng cuốc cắt cỏ và trồng cây.
A man cooking food on the stove.	Một người đàn ông nấu ăn trên lò nướng.	Một người đàn ông đang nấu ăn trên bếp.
A man in jeans at the beach playing with a red ball.	Một người mặc quần bò ở bãi biển chơi bóng đỏ.	Một người đàn ông mặc quần jean đang chơi với một quả bóng đỏ trên bãi biển.
People walking down sidewalk next to a line of stores.	Mọi người đi bộ dọc theo một hàng của các cửa hàng.	Mọi người đi bộ trên vỉa hè bên cạnh một dãy cửa hàng.
A wakeboarder performs a flip while being towed at high speed.	Một người lái máy bay hạ cánh một lúc để được kéo với tốc độ cao.	Người lướt ván thực hiện động tác lộn nhào trong khi được kéo đi với tốc độ cao.
A large group of people fill a street.	Một nhóm đông người trên một con đường.	Một nhóm đông người tụ tập trên phố.
A man on a tag line going into the water.	Một người đàn ông trên một đường kẻ đang đi xuống nước.	Một người đàn ông đang chèo thuyền xuống nước.
A woman in jeans walks by a bus with an ad depicting a woman peering over her sunglasses.	Một phụ nữ mặc quần jean đi trên xe buýt với tấm quảng cáo miêu tả một người phụ nữ nhìn chằm chằm vào cái mũ của mình.	Một người phụ nữ mặc quần jean đi ngang qua một chiếc xe buýt có quảng cáo mô tả một người phụ nữ đang nhìn qua kính râm.
A man in a pink shirt is sitting in the grass and a ball is in the air.	Một người đàn ông mặc áo sơ mi màu hồng đang ngồi trên cỏ và một quả bóng đang bay trên không.	Một người đàn ông mặc áo sơ mi hồng đang ngồi trên bãi cỏ và một quả bóng đang bay trên không trung.
A car parked at the beach.	Một chiếc xe ở bãi biển.	Một chiếc xe đậu ở bãi biển.
Two men wearing black in a city	Hai người đàn ông mặc màu đen đen đen đen đen trong một thành	Hai người đàn ông mặc đồ đen trong thành phố
The man in the yellow pants is raising his arms.	Người đàn ông mặc quần màu vàng đang giơ tay.	Người đàn ông mặc quần vàng đang giơ tay lên.
Two men wearing hats and using walking sticks are walking near a body of water during sundown.	Hai người đàn ông đội mũ và dùng gậy đi bộ đang đi gần một hồ nước vào lúc mặt trời lặn.	Hai người đàn ông đội mũ và chống gậy đang đi bộ gần một vùng nước lúc hoàng hôn.
A cheerleading team doing a routine on chairs.	Một đội bóng đang tập luyện.	Một đội cổ vũ đang biểu diễn trên ghế.
A boy is playing checkers with an adult shown off-screen while a girl looks on.	Một cậu bé đang chơi cờ bạc với một người trưởng thành khoe khoang trong khi một cô gái nhìn vào.	Một cậu bé đang chơi cờ với một người lớn đứng ngoài màn hình trong khi một cô gái đang nhìn theo.
A crowd of people out for some fun in public park.	Có rất nhiều người ra ngoài chơi ở công viên.	Một đám đông đang vui chơi ở công viên công cộng.
A man sits on a bench holding his dog and looking at the water.	Một người đàn ông ngồi trên băng ghế ôm con chó và nhìn xuống nước.	Một người đàn ông ngồi trên băng ghế, bế con chó của mình và nhìn xuống nước.
A boy and his younger brother playing together at the playground.	Một đứa con trai và em trai nó chơi với nhau ở sân chơi.	Một cậu bé và em trai đang chơi đùa cùng nhau ở sân chơi.
A woman in blue looks in a black leather bag while sitting on a bench during a sunny afternoon while people and limousines passed behind her.	Một người phụ nữ màu xanh nhìn trong một túi da màu đen trong khi ngồi trên một băng ghế dài vào một buổi chiều trong khi mọi người và eng đã đi qua phía sau cô.	Một người phụ nữ mặc đồ xanh nhìn vào chiếc túi da đen khi ngồi trên băng ghế vào một buổi chiều nắng trong khi mọi người và xe limousine đi qua phía sau cô.
The brown dog is standing on the sandy beach.	Con chó màu nâu đang đứng trên bãi cát.	Con chó nâu đang đứng trên bãi cát.
A woman is sitting with a basket of cloth, surrounded by cloth.	Một người đờn bà ngồi chung_quanh mình đầy một cái giỏ vải .	Một người phụ nữ đang ngồi với một giỏ vải, xung quanh là vải.
A man is grilling out in his backyard.	Một người đàn ông đang ra sân sau nhà mình.	Một người đàn ông đang nướng thịt ở sân sau nhà mình.
A woman sings in a club with a guitarist behind her.	Một phụ nữ hát trong một câu lạc bộ với một người có uy tín đằng sau.	Một người phụ nữ đang hát trong câu lạc bộ với một nghệ sĩ guitar chơi đàn phía sau cô ấy.
Guitar player performs at a nightclub red guitar.	Những người chơi biểu diễn tại một hộp đêm màu đỏ.	Người chơi guitar biểu diễn tại một hộp đêm bằng cây đàn guitar đỏ.
A child sitting on a lawn chair looking up at the camera	Một đứa trẻ ngồi trên một chiếc xe trượt băng nhìn lên máy ảnh	Một đứa trẻ đang ngồi trên ghế dài nhìn lên máy ảnh
Two ladies and three men looking at the ocean.	Hai quý cô và ba người đang nhìn vào biển cả.	Hai người phụ nữ và ba người đàn ông đang nhìn ra đại dương.
A female performer with a violin plays on a street while a woman with a blue guitar looks on.	Một nữ diễn viên chơi đàn trên đường phố, trong khi một phụ nữ với một cây guitar màu xanh.	Một nghệ sĩ nữ chơi đàn violin trên phố trong khi một người phụ nữ cầm đàn guitar màu xanh đứng nhìn.
A young girl swimming in a pool	♪ Một cô gái trẻ đang bơi trong hồ	Một cô gái trẻ đang bơi trong hồ bơi
Several children are outdoors getting ready to play tug-of-war.	Một vài đứa trẻ đang sẵn sàng để chơi đùa trong chiến tranh.	Một số trẻ em đang ở ngoài trời chuẩn bị chơi trò kéo co.
Three teenagers in a subway playing around.	Ba đứa trẻ chơi điện tử.	Ba thiếu niên đang chơi đùa trên tàu điện ngầm.
A brown dog walks in the grass with its tongue hanging out.	Một con chó màu nâu bước đi trên cỏ với cái lưỡi treo lơ lửng.	Một con chó nâu đi trên bãi cỏ với cái lưỡi thè ra.
People sitting in the grass outside a building, taking a break.	Những người ngồi trên cỏ ngoài một tòa nhà, nghỉ ngơi.	Mọi người đang ngồi trên bãi cỏ bên ngoài tòa nhà để nghỉ ngơi.
Shirtless guy staring off in the distance while three woman are walking past a crowd sitting outside a cafe.	Một người đàn ông yếu đuối đang nhìn chằm chằm vào khoảng cách trong khi ba người phụ nữ đang đi qua một đám đông ngồi bên ngoài quán cà phê.	Một anh chàng cởi trần nhìn chằm chằm vào khoảng không trong khi ba người phụ nữ đang đi ngang qua đám đông đang ngồi bên ngoài một quán cà phê.
Two young boys putting fruit on the bike.	Hai chàng trai trẻ đang đeo hoa quả trên xe.	Hai cậu bé đang chất trái cây lên xe đạp.
A man in a black t-shirt, cap and jeans is playing drums on an upside down yellow pail.	Một người đàn ông mặc áo thun màu đen, đội nón và quần jean đang chơi trống trên một chiếc áo lót màu vàng.	Một người đàn ông mặc áo phông đen, mũ lưỡi trai và quần jean đang chơi trống trên một chiếc thùng màu vàng úp ngược.
A young female artists paints an image of a woman on a wall.	Một nữ nghệ sĩ trẻ vẽ một hình ảnh của một người phụ nữ trên tường.	Một nữ họa sĩ trẻ đang vẽ hình ảnh một người phụ nữ trên tường.
Two female members of team USA performing a jump high-five surrounded by two other female members.	Hai thành viên nữ trong đội chuẩn bị một cú nhảy cao với hai thành viên nữ khác.	Hai thành viên nữ của đội tuyển Hoa Kỳ thực hiện động tác nhảy cao, xung quanh là hai thành viên nữ khác.
A man stirring a pot of liquid in this kitchen.	Một người đàn ông nấu một bình nước trong nhà bếp này.	Một người đàn ông đang khuấy một nồi chất lỏng trong bếp.
The boy is wakeboarding on the lake.	Cậu bé đang lướt trên cái hồ.	Cậu bé đang lướt ván trên hồ.
A man is working a hotdog stand.	Một người đàn ông đang làm việc cho một quán ăn hot dog.	Một người đàn ông đang làm việc tại một quầy bán xúc xích.
A large group of people of various ages and genders sit outside together.	Một nhóm đông những người thuộc nhiều lứa tuổi và giới tính ngồi chung với nhau.	Một nhóm lớn người ở nhiều độ tuổi và giới tính khác nhau ngồi cùng nhau ở bên ngoài.
A blond-haired woman is pouring drinks at a bar.	Một phụ nữ tóc vàng đang uống rượu tại một quán bar.	Một người phụ nữ tóc vàng đang rót đồ uống tại quầy bar.
A small child wearing a blue and white t-shirt happily holding a yellow plastic alligator.	Một đứa trẻ mặc một chiếc áo thun màu xanh trắng và trắng vui vẻ cầm một cái hộp nhựa màu vàng.	Một đứa trẻ mặc áo phông xanh trắng đang vui vẻ cầm một con cá sấu bằng nhựa màu vàng.
A woman with pink hair dressed in black talks to a man.	Một người phụ nữ với mái tóc màu hồng màu đen nói chuyện với một người đàn ông.	Một người phụ nữ tóc hồng mặc đồ đen đang nói chuyện với một người đàn ông.
The man in a Japanese cooking suit is preparing a meal for two people.	Người đàn ông trong bộ đồ bảo hộ nấu ăn Nhật đang chuẩn bị bữa ăn cho hai người.	Người đàn ông mặc bộ đồ đầu bếp Nhật Bản đang chuẩn bị bữa ăn cho hai người.
A girl hops across the river, from rock to rock.	Một cô gái nhảy qua con sông, từ tảng đá này sang tảng đá khác.	Một cô gái nhảy qua sông, từ tảng đá này sang tảng đá khác.
A male worker with his tool box is kneeling next to two women.	Một người nam làm việc với hộp dụng cụ của mình nằm cạnh hai phụ nữ.	Một công nhân nam với hộp dụng cụ đang quỳ bên cạnh hai người phụ nữ.
An older man is opening his arms wide and looking perplexed.	Một người đàn ông lớn tuổi đang mở rộng vòng tay và nhìn chằm chằm.	Một người đàn ông lớn tuổi đang dang rộng vòng tay và trông có vẻ bối rối.
A child in a white karate outfit practicing a move	Một đứa trẻ mặc bộ đồ trắng trắng đang thực hiện một bước di chuyển	Một đứa trẻ mặc trang phục karate màu trắng đang tập luyện một động tác
Three men in same colored vests are in the outdoors.	Ba người mặc áo chống đạn cùng màu đang ở ngoài.	Ba người đàn ông mặc áo vest cùng màu đang ở ngoài trời.
A woman takes a picture of a baby wearing a pink hat while a man carries her.	Một người phụ nữ chụp ảnh một em bé đội một cái mũ hồng trong khi một người đàn ông ôm em bé.	Một người phụ nữ chụp ảnh một em bé đội mũ hồng trong khi một người đàn ông đang bế em bé.
A group of mostly asian children sitting at cubicles in blue chairs.	Một nhóm trẻ em đa số là những đứa trẻ gốc Ấn đang ngồi trên ghế màu xanh.	Một nhóm trẻ em chủ yếu là người châu Á đang ngồi ở các ô trên ghế màu xanh.
A young boy in a soccer uniform crying into his palms.	Một cậu bé mặc đồng phục bóng khóc lóc trong lòng bàn tay.	Một cậu bé mặc đồng phục bóng đá đang khóc úp mặt vào lòng bàn tay.
A happy woman is preparing a refreshment at a coffee shop.	Một người đàn bà hạnh phúc đang chuẩn bị giải trí tại quán cà phê.	Một người phụ nữ vui vẻ đang chuẩn bị đồ uống giải khát tại một quán cà phê.
A construction worker is driving heavy equipment at a work site.	Một công nhân xây cất đang vận dụng những dụng cụ nặng nhọc tại nơi làm việc.	Một công nhân xây dựng đang lái thiết bị hạng nặng tại công trường.
A woman runs after making a hit in women's softball, the catcher rises to her feet.	Một người phụ nữ chạy sau khi làm một cú đánh vào của phụ nữ, người bắt bóng tăng lên bàn chân của mình.	Một người phụ nữ chạy sau khi thực hiện cú đánh trong môn bóng mềm nữ, người bắt bóng đứng dậy.
A man in a work uniform passing a tool to another person.	Một người đàn ông trong một đồng phục đồng phục đi qua một công cụ cho một người khác.	Một người đàn ông mặc đồng phục lao động đang trao dụng cụ cho người khác.
A group of people are climbing in cold weather.	Một nhóm người đang trong thời tiết lạnh.	Một nhóm người đang leo núi trong thời tiết lạnh giá.
A mountaineer about to descend down a mountain with a blue helmet on.	Một vệ sĩ chuẩn bị hạ xuống một ngọn núi với một chiếc mũ bảo hiểm màu xanh.	Một người leo núi chuẩn bị xuống núi với chiếc mũ bảo hiểm màu xanh trên đầu.
A man doing handstand on top of a round statue.	Một người đàn ông đang làm bàn tay trên đầu của một bức tượng tròn.	Một người đàn ông đang đứng trên đỉnh một bức tượng tròn.
A child sitting at a restaurant table holding a paper mask against his face.	Một đứa trẻ ngồi ở bàn ăn với một mặt nạ đeo mặt nạ chống lại khuôn mặt của mình.	Một đứa trẻ đang ngồi ở bàn ăn trong nhà hàng và áp mặt nạ giấy vào mặt.
A brown dog wades into a lake to retrieve a stick.	Một con chó màu nâu lao vào một cái hồ để lấy một cái que.	Một chú chó nâu lội xuống hồ để nhặt một cây gậy.
A mother teaches her two young boys to fish off of a rocky coast into very blue water.	Một người mẹ dạy cho hai con trai nhỏ của mình cách tách cá ra khỏi bờ biển trong nước rất xanh.	Một người mẹ dạy hai cậu con trai nhỏ cách câu cá ngoài khơi bờ biển đầy đá vào vùng nước trong xanh.
A little kid is walking next to red banners.	Một đứa bé nhỏ đang đi kế bên những tấm bảng màu đỏ.	Một đứa trẻ đang đi cạnh những tấm biểu ngữ màu đỏ.
A girl sits on a decorated bike with a younger boy while another girl takes a picture.	Một cô gái ngồi trên một chiếc xe đạp với một em trai nhỏ trong khi một cô gái khác chụp ảnh.	Một cô gái ngồi trên chiếc xe đạp được trang trí cùng một cậu bé nhỏ tuổi hơn trong khi một cô gái khác đang chụp ảnh.
A black dog is retrieving a ball in water.	Một con chó mực là một quả bóng trong nước.	Một con chó đen đang nhặt một quả bóng dưới nước.
A man in white pants and a blue shirt is kicking a yellow boxing bag.	Một người đàn ông mặc quần trắng và một cái áo sơ mi màu xanh đang ném một cái túi vàng.	Một người đàn ông mặc quần trắng và áo sơ mi xanh đang đá bao cát màu vàng.
Two Indian men participating in a ceremony.	Hai người đàn ông da đỏ trong một buổi lễ.	Hai người đàn ông Ấn Độ đang tham gia một buổi lễ.
A boy with a bruised nose and writing on his hands is standing in a video rental store.	Một cậu bé với một cái mũi bị dập và viết trên tay đang đứng trong một cửa hàng video.	Một cậu bé với chiếc mũi bầm tím và chữ viết trên tay đang đứng trong một cửa hàng cho thuê băng video.
Two silhouetted people paddle a canoe on the ocean during sunset.	Có hai người chèo thuyền trên biển vào lúc mặt trời lặn.	Hai bóng người chèo thuyền độc mộc trên biển vào lúc hoàng hôn.
People are standing on a crowded subway, and the platform outside is visible through the window.	Mọi người đang đứng trên một tàu điện ngầm đông đúc, và sân ga bên ngoài là nhìn thấy thông qua cửa sổ.	Mọi người đang đứng trên một tàu điện ngầm đông đúc, và có thể nhìn thấy sân ga bên ngoài qua cửa sổ.
Man scaling wall with fire in hand	♪ Trong bức tường với lửa trong tay ♪	Người đàn ông trèo tường với ngọn lửa trên tay
Two brown dogs are running through the snow.	Hai con chó màu nâu đang chạy qua tuyết.	Hai chú chó nâu đang chạy trên tuyết.
On stage photo of small band performing for theater audience.	Trên sân khấu của một ban nhạc nhỏ đang biểu diễn cho khán giả.	Bức ảnh trên sân khấu của một ban nhạc nhỏ đang biểu diễn cho khán giả nhà hát.
A baby in a Christmas outfit looks at the camera.	Một em bé trong một buổi tiệc giáng sinh nhìn vào máy quay.	Một em bé mặc trang phục Giáng sinh đang nhìn vào máy ảnh.
A man is sitting next to a computer monitor.	Một người đàn ông ngồi cạnh một máy tính.	Một người đàn ông đang ngồi cạnh màn hình máy tính.
This lady has heard a funny joke and laughing.	Quý cô đây đã nghe thấy một trò cười hài hước và cười.	Người phụ nữ này đã nghe một câu chuyện cười buồn cười và bật cười.
People inside of a building, one is taking a photo.	Những người ở bên trong một tòa nhà, một người chụp ảnh.	Mọi người bên trong tòa nhà, một người đang chụp ảnh.
Four white dogs with muzzles jump over a red wall.	Bốn tên da trắng với cái quần lót nhảy qua tường đỏ.	Bốn con chó trắng có mõm nhảy qua bức tường đỏ.
The woman with the blue shirt is holding a baby.	Người phụ nữ mặc áo sơ mi đang bế một đứa bé.	Người phụ nữ mặc áo sơ mi xanh đang bế một đứa bé.
Two people are sitting fishing on striped beach chairs in a body of water.	Hai người đang ngồi câu cá trên ghế có sọc trong một hồ nước.	Hai người đang ngồi câu cá trên những chiếc ghế sọc trên bãi biển ở một vùng nước.
An old woman working at a loom making cloth.	Một bà già làm việc trong một tấm vải dệt.	Một bà lão đang dệt vải bên khung cửi.
A boy standing in the foreground looking out over other people in a court.	Một cậu bé đứng ngoài đường canh chừng những người khác trong tòa án.	Một cậu bé đứng ở phía trước nhìn xuống những người khác trong tòa án.
A man in a blue coat grabbing a young boy's shoulder.	Một người mặc áo khoác xanh ôm vai một chàng trai trẻ.	Một người đàn ông mặc áo khoác xanh đang nắm lấy vai một cậu bé.
Three brown dogs are jumping up at the woman wearing blue.	Ba con chó màu nâu đang nhảy vào người phụ nữ mặc màu xanh.	Ba con chó nâu đang nhảy lên người phụ nữ mặc đồ xanh.
A boy hangs out of a passing taxi cab window	Một chàng trai đi ra khỏi một chiếc taxi taxi đồng hồ có tiếng	Một cậu bé thò đầu ra ngoài cửa sổ xe taxi đang chạy qua
A man in a gray shirt jumps over the top of a sand dune in the desert.	Một người đàn ông mặc áo sơ mi màu xám nhảy lên đỉnh cát trong sa mạc.	Một người đàn ông mặc áo sơ mi xám nhảy qua đỉnh đồi cát ở sa mạc.
A child wearing a yellow shirt is jumping up and down.	Một đứa trẻ mặc áo vàng đang nhảy lên nhảy xuống.	Một đứa trẻ mặc áo sơ mi vàng đang nhảy lên nhảy xuống.
A worker in a yellow jacket is hoisted up high to work on a building.	Một nhân viên mặc áo khoác màu vàng được trang trí cao để làm việc trên một tòa nhà.	Một công nhân mặc áo khoác vàng được kéo lên cao để làm việc trên một tòa nhà.
A man in Brazil giving an informal talk to young adults.	Một người đàn ông ở Brazil nói chuyện trò chuyện với người trẻ.	Một người đàn ông ở Brazil đang có buổi nói chuyện thân mật với những người trẻ tuổi.
A bunch of beer pull tabs at a bar with Christmas lights on the ceiling.	Cả tá bia đến quán bar với đèn giáng sinh trên trần nhà.	Một loạt các loại bia kéo ở một quán bar có đèn Giáng sinh trên trần nhà.
A man is abseiling down a cliff over the ocean.	Một người đàn ông đang lao xuống một vách đá trên đại dương.	Một người đàn ông đang đu dây xuống một vách đá trên biển.
A man in black is walking to his truck in the snow.	Một người đàn ông mặc đồ đen đang đi đến xe tải của mình trong tuyết.	Một người đàn ông mặc đồ đen đang đi bộ trong tuyết đến xe tải của mình.
A fox terrier leaps after a ball.	Một nhà tiên phong đang đuổi theo một quả bóng.	Một con chó sục cáo nhảy theo quả bóng.
A female police officer in a cap and navy uniform smiles while wearing sunglasses outside of a shop.	Một nữ cảnh sát nữ đeo mũ và mặc đồng phục mỉm cười trong khi mặc áo choàng ngoài cửa hàng.	Một nữ cảnh sát đội mũ lưỡi trai và mặc đồng phục hải quân mỉm cười trong khi đeo kính râm bên ngoài một cửa hàng.
A Family going for a walk in a park.	Một gia đình đi dạo trong một công viên.	Một gia đình đang đi dạo trong công viên.
A man in a green hard hat and yellow safety vest frowns.	Một người đàn ông với mũ xanh và áo chống đạn.	Một người đàn ông đội mũ cứng màu xanh lá cây và mặc áo an toàn màu vàng đang cau mày.
Child with pink strings on head dancing surrounded by confetti, balloons.	Em bé với những sợi dây đeo trên đầu nhảy múa xung quanh là hoa ringetti, bóng bay.	Đứa trẻ với dây hoa màu hồng trên đầu đang nhảy múa xung quanh là những mảnh giấy vụn và bóng bay.
A dog with a snub nose smells for something on a riverbank.	Một con chó với cái mũi run rẩy để làm gì đó trên bờ sông.	Một con chó có chiếc mũi hếch đang đánh hơi thứ gì đó trên bờ sông.
A man prepares his local stand for the days business.	Một người đàn ông chuẩn bị vị trí địa phương cho công việc thường ngày.	Một người đàn ông đang chuẩn bị gian hàng địa phương cho ngày kinh doanh.
A man in a red shirt is about to eat a taco.	Một người đàn ông mặc áo sơ mi màu đỏ sắp ăn thịt một con cá sấu.	Một người đàn ông mặc áo sơ mi đỏ sắp ăn một chiếc bánh taco.
A young lady in white holding a tennis racket	Một cô gái trẻ mặc áo trắng cầm vợt	Một cô gái trẻ mặc đồ trắng đang cầm vợt tennis
A boy wearing a red shirt digs into the sand with a yellow shovel.	Một cậu bé đội một chiếc áo sơ mi đỏ đào vào cát với một cái xẻng.	Một cậu bé mặc áo sơ mi đỏ đang đào cát bằng một chiếc xẻng màu vàng.
An individual wearing rose jacket site idle on a wooden bench.	Một người mặc áo hồng trang trí trên một chiếc ghế dài.	Một người mặc áo khoác màu hồng đang ngồi nhàn rỗi trên một chiếc ghế gỗ.
A man wearing a white shirt is looking out a window of a metal construction.	Một người mặc áo sơ mi trắng đang nhìn ra ngoài cửa sổ của một công trình xây dựng.	Một người đàn ông mặc áo sơ mi trắng đang nhìn ra cửa sổ của một công trình bằng kim loại.
A woman is holding a small white statue.	Một người phụ nữ đang nắm giữ một khối trắng nhỏ.	Một người phụ nữ đang cầm một bức tượng nhỏ màu trắng.
Six shirtless children are playing in natural water and splashing around.	Những đứa trẻ không mặc áo sơ mi đang chơi đùa trong nước tự nhiên và lượn lờ xung quanh.	Sáu đứa trẻ cởi trần đang chơi đùa trong làn nước tự nhiên và té nước.
Two people riding bikes through a mountainous region.	Hai người chạy xuyên qua một dãy núi.	Hai người đạp xe qua một vùng núi.
A girl jumping rope on a sidewalk near a parking garage.	Một cô gái nhảy trên một vỉa hè gần bãi đậu xe.	Một cô gái đang nhảy dây trên vỉa hè gần bãi đỗ xe.
A man wearing an orange shirt and helmet.	Một người đàn ông đội một chiếc áo sơ mi màu cam và đội mũ bảo hiểm.	Một người đàn ông mặc áo sơ mi màu cam và đội mũ bảo hiểm.
A small boy plays with plastic blocks, cars, and animals with an adult watching closely.	Một cậu bé chơi với những khối nhựa, xe hơi và động vật với một người lớn quan sát chặt chẽ.	Một cậu bé đang chơi với những khối nhựa, ô tô và động vật trong khi người lớn đang quan sát chặt chẽ.
A little girl opening a Christmas present.	Một bé gái đang mở một món quà Giáng sinh.	Một bé gái đang mở quà Giáng sinh.
The woman in blue is operating a camera in front of two other women.	Người phụ nữ màu xanh đang quay phim trước mặt hai người phụ nữ khác.	Người phụ nữ mặc áo xanh đang sử dụng máy quay trước mặt hai người phụ nữ khác.
A little girl tries taking a nap on the comfy sofa.	Một cô bé đang ngủ trên giường.	Một bé gái đang cố ngủ trưa trên chiếc ghế sofa thoải mái.
A brown and black dog running on a trail in the woods.	Một con chó màu nâu đen chạy trên một con đường mòn trong rừng.	Một con chó nâu và đen đang chạy trên đường mòn trong rừng.
Two dogs play by a tree.	Hai con chó chơi bởi một cái cây.	Hai con chó đang chơi đùa dưới một cái cây.
A navy walking wearing a black coat and pants on the stairs as camera focuses on the dog	♪ Một hải du du du du du du du du du du du du dương	Một người lính hải quân mặc áo khoác và quần đen đang đi trên cầu thang khi máy quay tập trung vào con chó
Two men dressed in green are preparing food in a restaurant.	Có hai người đàn ông mặc đồ xanh đang chuẩn bị thức ăn trong nhà hàng.	Hai người đàn ông mặc đồ xanh đang chuẩn bị đồ ăn trong một nhà hàng.
A man dressed in black leather and a cowboy hat is walking around a Renaissance Festival.	Một chàng cao bồi mặc đồ da đen và một cái nón đang đi dạo quanh một buổi lễ hội.	Một người đàn ông mặc đồ da đen và đội mũ cao bồi đang đi dạo quanh Lễ hội Phục hưng.
A dog runs outside with a yellow toy.	Một con chó ở bên ngoài với một món đồ chơi màu vàng.	Một con chó chạy ra ngoài với một món đồ chơi màu vàng.
A dog wearing a cover runs in the snow.	Một con chó đội khăn trùm đầu trong tuyết tuyết.	Một chú chó mặc áo choàng chạy trong tuyết.
A family is playing on the beach with their dog.	Một gia đình đang chơi đùa trên bãi biển với con chó của họ.	Một gia đình đang chơi đùa trên bãi biển với chú chó của họ.
A woman and a child embrace while the child tastes what they have been making.	Một người đàn bà và một đứa trẻ ôm ấp trong khi đứa trẻ nếm thử những gì chúng đã làm.	Một người phụ nữ và một đứa trẻ ôm nhau trong khi đứa trẻ nếm thử những gì họ đã làm.
Two men and a lady are standing outside.	Hai người đàn ông và một quý bà đang đứng ngoài.	Hai người đàn ông và một người phụ nữ đang đứng bên ngoài.
A group of men using logs to push a boat out of the water.	Một nhóm người sử dụng gỗ để đẩy một chiếc thuyền ra khỏi mặt nước.	Một nhóm đàn ông dùng khúc gỗ để đẩy thuyền ra khỏi mặt nước.
A man drinks from a wineglass while reading the paper.	Một người uống rượu trong khi đang đọc báo.	Một người đàn ông uống rượu từ ly thủy tinh trong khi đọc báo.
A man wearing a all black and playing a piano.	Một người đàn ông mặc đồ đen và chơi đàn piano.	Một người đàn ông mặc đồ đen và đang chơi đàn piano.
A young boy wearing a blue jersey and yellow shorts is playing soccer.	Một cậu bé mặc áo lót màu xanh và quần vàng đang chơi bóng đá.	Một cậu bé mặc áo xanh và quần đùi vàng đang chơi bóng đá.
A man is standing on a stone structure with his arms out like a bird.	Một người đàn ông đang đứng trên một tảng đá với cánh tay giơ ra như một con chim.	Một người đàn ông đang đứng trên một cấu trúc đá với hai cánh tay dang rộng như một chú chim.
A dog drinks water outside on the grass.	Một con chó uống nước ngoài bãi cỏ.	Một con chó đang uống nước trên bãi cỏ bên ngoài.
Two women wearing tank tops are looking at the camera.	2 phụ nữ mặc áo cao su đang nhìn vào camera.	Hai người phụ nữ mặc áo ba lỗ đang nhìn vào máy ảnh.
A man is sitting in a barber's chair getting ready for a shave.	Một người đàn ông ngồi trên ghế thợ cạo chuẩn bị sẵn sàng để cạo râu.	Một người đàn ông đang ngồi trên ghế cắt tóc, chuẩn bị cạo râu.
A young child wearing green boots playing in a mud puddle	♪ Một em bé gái mới nhỏ đang mặc một đôi giày xanh ♪ Trong một tình yêu ♪	Một đứa trẻ đi ủng xanh đang chơi trong vũng bùn
A man using a chainsaw to cut lumber.	Một người đàn ông dùng máy cưa để cắt.	Một người đàn ông đang sử dụng cưa máy để cắt gỗ.
A man sitting at a picnic table with a tray and partially consumed beer in front of him.	Một người đàn ông ngồi tại một bàn ăn với một khay và một phần bia trước mặt anh ta.	Một người đàn ông đang ngồi ở bàn ăn ngoài trời với một chiếc khay và đang uống một nửa bia trước mặt.
The boy wearing a black shirt and blue jeans is holding a red baseball bat.	Thằng bé mặc áo sơ mi đen và quần xanh đang đeo một cây bóng chày màu đỏ.	Cậu bé mặc áo sơ mi đen và quần jean xanh đang cầm một cây gậy bóng chày màu đỏ.
A dark-haired bearded man in glasses and a Hawaiian shirt is sitting on the grass.	Một người đàn ông có mái tóc đen đeo kính và áo sơ mi đang ngồi trên cỏ.	Một người đàn ông tóc đen, râu quai nón, đeo kính và mặc áo sơ mi Hawaii đang ngồi trên bãi cỏ.
Dogs run at a dog racetrack.	Chó chạy đua với chó đua.	Những chú chó chạy ở trường đua chó.
A light technician man with tribal tattoos aiming a spotlight over a balcony.	Một người đàn ông ánh sáng với âm đạo trên ban công.	Một kỹ thuật viên ánh sáng có hình xăm bộ lạc đang chiếu đèn rọi vào ban công.
Two German sheperds snarling at each other.	Hai cô gái Đức đang nói chuyện với nhau.	Hai con chó chăn cừu Đức đang gầm gừ với nhau.
This is a group of people standing around at some sort of event.	Đây là một nhóm người đang đứng xung quanh tại một sự kiện nào đó.	Đây là hình ảnh một nhóm người đang đứng xung quanh tại một sự kiện nào đó.
A brown and white dog fetching a toy.	Một con chó màu trắng màu nâu đang đi lấy một món đồ chơi.	Một chú chó nâu và trắng đang nhặt đồ chơi.
Man with white hair playing an accordion in the middle of some buildings.	Người đàn ông với mái tóc trắng đang chơi trò thắt lưng ở giữa một số tòa nhà.	Người đàn ông tóc trắng đang chơi đàn accordion giữa một tòa nhà.
A woman with brown hair sitting on a bench outside a cafe.	Một người phụ nữ tóc nâu ngồi trên ghế ngồi bên ngoài quán cà phê.	Một người phụ nữ tóc nâu đang ngồi trên băng ghế bên ngoài một quán cà phê.
A man next to a bicycle is playing a pan flute.	Một người đàn ông cạnh một chiếc xe đạp đang thổi sáo.	Một người đàn ông đang chơi sáo pan bên cạnh chiếc xe đạp.
Two kids are balancing on a log and holding a rope.	Hai đứa trẻ đang đứng trên một khúc gỗ và nắm lấy một sợi dây thừng.	Hai đứa trẻ đang giữ thăng bằng trên một khúc gỗ và cầm một sợi dây thừng.
A man riding a motorcycle is performing a trick at a track.	Một người đàn ông lái xe mô tô đang biểu diễn trên đường đua.	Một người đàn ông đang lái xe máy đang biểu diễn một trò ảo thuật trên đường đua.
A young woman with a purple cloth hiding her face relaxes on a wooden deck.	Một người đàn bà trẻ với một sợi dây màu tím che mặt mình thả lỏng trên một tấm ván gỗ.	Một phụ nữ trẻ với tấm vải màu tím che mặt đang thư giãn trên sàn gỗ.
The woman in the brown shirt is sitting on a bright red bench.	Người phụ nữ mặc áo nâu đang ngồi trên một chiếc ghế màu đỏ tươi.	Người phụ nữ mặc áo sơ mi nâu đang ngồi trên một chiếc ghế dài màu đỏ tươi.
A dog walks on a log across a small river.	Một con chó đi trên một khúc gỗ băng qua một con sông nhỏ.	Một con chó đi trên khúc gỗ băng qua một con sông nhỏ.
A young man wearing a white t-shirt and green and black shorts standing on a stump.	Một người đàn ông trẻ mặc áo thun trắng, xanh lá và quần shorts đen đứng trên một ngón chân.	Một thanh niên mặc áo phông trắng và quần short xanh lá cây và đen đang đứng trên một gốc cây.
The group of people are all covered by umbrellas.	Tất cả mọi người đều bị che phủ bởi những cái ô.	Cả nhóm người đều che ô.
A man advertises with a giant sign tied onto his bicycle.	Một người đàn ông quảng cáo bằng một tấm bảng khổng lồ buộc vào chiếc xe đạp của mình.	Một người đàn ông quảng cáo bằng một tấm biển khổng lồ buộc vào xe đạp.
A man is throwing a log into a waterway while two dogs watch.	Một người đàn ông đang ném một khúc gỗ xuống nước trong khi hai con chó canh.	Một người đàn ông đang ném một khúc gỗ xuống đường thủy trong khi hai con chó đứng nhìn.
Group of elders playing instruments under a tent by the water.	Một nhóm trưởng lão chơi nhạc dưới lều bên bờ suối.	Nhóm người lớn tuổi đang chơi nhạc cụ dưới một chiếc lều bên bờ nước.
A view of a crowded city street.	Một quang cảnh của một khu phố đông đúc.	Cảnh quan của một con phố đông đúc trong thành phố.
A young blond woman holds a white rope on a sunny day.	Một phụ nữ trẻ tuổi đeo một sợi dây thừng trắng vào một ngày nắng.	Một phụ nữ trẻ tóc vàng cầm một sợi dây thừng màu trắng vào một ngày nắng.
Two people in blue shirts are outside with a bullhorn.	Hai người mặc áo xanh đang ở ngoài với một con bò sừng.	Hai người mặc áo sơ mi xanh đang ở bên ngoài cầm loa phóng thanh.
A black dog springs up into a pool.	Một con chó da đen lập thành một hồ bơi.	Một con chó đen nhảy lên hồ nước.
A cowboy riding on the back of a bronco in a competition.	Một chàng cao bồi cưỡi trên lưng của một Bronco trong một cuộc thi.	Một chàng cao bồi đang cưỡi trên lưng ngựa trong một cuộc thi.
A railroad work crew performs maintenance on railroad tracks.	Một đoàn tàu đường sắt thực hiện việc sửa chữa đường sắt.	Một đội công nhân đường sắt đang bảo trì đường ray xe lửa.
A worker in an orange vest is using a shovel.	Một người làm việc trong một áo giáp màu cam đang sử dụng một cái xẻng.	Một công nhân mặc áo vest màu cam đang sử dụng xẻng.
Two construction workers have a discussion while on the work site.	Hai công nhân xây dựng có một cuộc thảo luận trong công việc.	Hai công nhân xây dựng đang thảo luận trong khi làm việc tại công trường.
Three men are walking up hill.	Ba người đàn ông đang đi lên đồi.	Ba người đàn ông đang đi lên đồi.
An Asian woman in a floral wedding dress poses on a bridge close to her bridesmaids.	Một phụ nữ Á Rập mặc váy cưới hoa hồng trên một cây cầu gần khớp với hậu môn của mình.	Một phụ nữ châu Á trong chiếc váy cưới hoa tạo dáng trên cầu gần các phù dâu của mình.
A young man tunes his guitar in the kitchen.	Một thanh niên chơi guitar trong nhà bếp.	Một chàng trai trẻ đang lên dây đàn guitar trong bếp.
Three boys are playing with sponges and buckets of water.	Ba cậu bé đang chơi đùa với bọt biển và những thùng nước.	Ba cậu bé đang chơi với miếng bọt biển và xô nước.
Three construction workers are mending pavement.	Những công nhân xây dựng đang sửa chữa.	Ba công nhân xây dựng đang sửa chữa vỉa hè.
People chilling in at forest next to canoes.	Mọi người ở trong rừng lạnh lẽo cạnh đống củi.	Mọi người đang thư giãn trong rừng bên cạnh những chiếc xuồng.
A choir group is gathered together in a church.	Một nhóm hợp xướng được tập hợp trong một nhà thờ.	Một nhóm hợp xướng đang tập trung tại một nhà thờ.
A group of young teenagers are jumping at night making funny poses for the camera.	Một nhóm thanh thiếu niên đang nhảy vào ban đêm làm trò cười cho máy ảnh.	Một nhóm thanh thiếu niên đang nhảy vào ban đêm và tạo dáng vui nhộn trước ống kính máy ảnh.
Two guys are kayaking, one orange one blue, down a creek.	Có hai người đang ngủ đông, một người da màu, một màu xanh da trời, dưới một dòng suối.	Hai chàng trai đang chèo thuyền kayak, một người màu cam và một người màu xanh, dọc theo một con suối.
Two workers spread cement onto a brick building.	Hai công nhân đã được băng bó thành một tòa nhà xây bằng gạch.	Hai công nhân đang rải xi măng lên một tòa nhà gạch.
A lady wearing a redish sweater and jeans is sitting with hands on her left knee	Một người phụ nữ mặc một chiếc áo len màu đỏ màu đỏ màu đỏ và quần lót đang ngồi với bàn tay đặt trên bàn tay trái của mình chân	Một người phụ nữ mặc áo len đỏ và quần jean đang ngồi với hai tay đặt trên đầu gối trái
Two performers putting on a mock fight for an audience that is watching attentively.	Hai người biểu diễn tranh nhau vì một khán giả đang xem.	Hai nghệ sĩ đang thực hiện một màn chiến đấu giả cho khán giả đang chăm chú theo dõi.
A GI relaxes and waits at an airport.	ARI thư giãn và chờ ở sân bay.	Một lính Mỹ đang thư giãn và chờ đợi ở sân bay.
A man in a yellow coat tends a fire, a boy in a parka watches.	Một người đàn ông mặc áo lông màu vàng có ngọn lửa, một cậu bé trong một chiếc đồng hồ công viên.	Một người đàn ông mặc áo khoác vàng đang nhóm lửa, một cậu bé mặc áo parka đang quan sát.
A man and a boy on a rocky beach.	Một người đàn ông và một cậu bé trên một bãi biển.	Một người đàn ông và một cậu bé trên bãi biển đầy đá.
"A woman on a boat named ""El Corazon"" drops black weights into the water."	"Một người phụ nữ trên thuyền tên là ""El Corazon"" thả trọng lượng đen xuống nước."	"Một người phụ nữ trên chiếc thuyền có tên ""El Corazon"" thả những quả tạ màu đen xuống nước."
A boy sitting on and looking out from a microscope.	Một cậu bé ngồi và nhìn ra khỏi một cái kính hiển vi.	Một cậu bé đang ngồi nhìn ra từ kính hiển vi.
A young barefoot girl in a pink dress is jumping outside.	Một cô gái trẻ mặc váy hồng đang nhảy ra ngoài.	Một cô gái trẻ chân trần mặc váy hồng đang nhảy ra ngoài.
Many people are sitting around a tent outside.	Nhiều người đang ngồi trong lều bên ngoài.	Nhiều người đang ngồi quanh một chiếc lều ở bên ngoài.
"A youth with a black shirt that says ""Asian Pacific 2007"" plays a drum while sitting."	"Một thanh niên với một chiếc áo đen có ghi ""Acian Pacific 2007"" chơi trống trong khi ngồi."	"Một thanh niên mặc áo sơ mi đen có dòng chữ ""Châu Á Thái Bình Dương 2007"" đang ngồi chơi trống."
A man selling items near the roadside to the great mountain of Canyon.	Một người đàn ông bán hàng gần bờ đê tới núi Grand Canyon.	Một người đàn ông đang bán hàng gần lề đường gần ngọn núi lớn Canyon.
The girl in yellow is laughing at the girl wearing orange whilst being watched by the girl in blue.	Cô gái mặc đồ vàng đang cười cô gái mặc áo da cam đang bị theo dõi bởi cô gái mặc áo xanh.	Cô gái mặc đồ vàng đang cười cô gái mặc đồ cam trong khi bị cô gái mặc đồ xanh nhìn chằm chằm.
A dog jumps over an obstacle outside.	Một con chó nhảy qua một con vật ở bên ngoài.	Một con chó nhảy qua chướng ngại vật ở bên ngoài.
Dog with black collar rolling in dirt and dried leaves	♪ ♪ Với đôi mắt với đôi ♪ ♪ ♪ ♪ Với đôi mắt trắng ♪ ♪ ♪ ♪ ♪ ♪ Với đôi ♪ ♪ ♪ ♪ ♪ ♪ ♪ ♪ ♪ ♪ ♪ ♪ ♪ ♪ ♪ ♪ ♪ ♪ ♪ ♪ ♪ ♪ ♪ ♪ ♪ ♪ ♪ ♪ ♪ ♪ ♪ ♪ ♪ ♪ ♪ ♪ ♪ ♪ ♪ ♪ ♪ ♪ ♪ ♪ ♪ ♪ ♪ ♪ ♪ ♪ ♪ ♪ ♪ ♪ ♪ ♪ ♪ ♪ ♪ ♪ ♪ ♪ ♪ ♪ ♪ ♪ ♪ ♪ ♪ ♪ ♪ ♪ ♪ ♪ ♪ ♪ ♪ ♪ ♪ ♪ ♪ ♪ ♪ ♪ ♪ ♪ ♪ ♪ ♪ ♪ ♪ ♪ ♪ ♪ ♪ ♪ ♪ ♪ ♪ ♪ ♪ ♪ ♪ ♪ ♪ ♪ ♪ ♪ ♪ ♪ ♪ ♪ ♪ ♪ ♪ ♪ ♪ ♪ ♪ ♪ ♪ ♪ ♪ ♪ ♪ ♪ ♪ ♪ ♪ ♪ ♪ ♪ ♪ ♪ ♪ ♪ ♪ ♪ ♪ ♪ ♪ ♪ ♪ ♪ ♪ ♪ ♪ ♪ ♪ ♪ ♪ ♪ ♪ ♪ ♪ ♪ ♪ ♪ ♪ ♪ ♪ ♪ ♪ ♪ ♪ ♪ ♪ ♪ ♪ ♪ ♪ ♪ ♪ ♪ ♪ ♪ ♪ ♪ ♪ ♪ ♪ ♪ ♪ ♪ ♪ ♪ ♪ ♪ ♪ ♪ ♪ ♪ ♪ ♪ ♪ ♪ ♪ ♪ ♪ ♪ ♪ ♪ ♪ ♪ ♪ ♪ ♪ ♪ ♪ ♪ ♪ ♪ ♪ ♪ ♪ ♪ ♪ ♪ ♪ ♪ ♪ ♪ ♪ ♪ ♪ ♪ ♪ ♪ ♪ ♪ ♪ ♪ ♪ ♪ ♪ ♪ ♪ ♪ ♪ ♪ ♪ ♪ ♪ ♪ ♪ ♪ ♪ ♪ ♪ ♪ ♪ ♪ ♪ ♪ ♪ ♪ ♪ ♪ ♪ ♪ ♪ ♪ ♪ ♪ ♪ ♪ ♪ ♪ ♪ ♪ ♪ ♪ ♪ ♪ ♪ ♪ ♪ ♪ ♪ ♪ ♪ ♪ ♪ ♪ ♪ ♪ ♪ ♪ ♪ ♪ ♪ ♪ ♪ ♪ ♪ ♪ ♪ ♪ ♪ ♪ ♪ ♪ ♪ ♪ ♪ ♪ ♪ ♪ ♪ ♪ ♪ ♪ ♪ ♪ ♪ ♪ ♪ ♪ ♪ ♪ ♪ ♪ ♪ ♪ ♪ ♪ ♪ ♪ ♪ ♪ ♪ ♪ ♪ ♪ ♪ ♪ ♪ ♪ ♪ ♪ ♪ ♪ ♪ ♪ ♪ ♪ ♪ ♪ ♪ ♪ ♪ ♪ ♪ ♪ ♪ ♪ ♪ ♪ ♪ ♪ ♪ ♪ ♪ ♪ ♪ ♪ ♪ ♪ ♪ ♪ ♪ ♪ ♪ ♪ ♪ ♪ ♪ ♪ ♪ ♪ ♪ ♪ ♪ ♪ ♪ ♪ ♪ ♪ ♪ ♪ ♪ ♪ ♪ ♪ ♪ ♪ ♪ ♪ ♪ ♪ ♪ ♪ ♪ ♪ ♪ ♪ ♪ ♪ ♪ ♪ ♪ ♪ ♪ ♪ ♪ ♪ ♪ ♪ ♪ ♪ ♪ ♪ ♪ ♪ ♪ ♪ ♪ ♪ ♪ ♪ ♪ ♪ ♪ ♪ ♪ ♪ ♪ ♪ ♪ ♪ ♪ ♪ ♪ ♪ ♪ ♪ ♪ ♪ ♪ ♪ ♪ ♪ ♪ ♪ ♪ ♪ ♪ ♪ ♪ ♪ ♪ ♪ ♪ ♪ ♪ ♪ ♪ ♪ ♪ ♪ ♪ ♪ ♪ ♪ ♪ ♪ ♪ ♪ ♪ ♪ ♪ ♪ ♪ ♪ ♪ ♪ ♪	Con chó đeo vòng cổ màu đen lăn trong đất và lá khô
Two brown dogs playing in a rough manner.	Hai con chó nâu chơi một cách thô.	Hai chú chó nâu đang chơi đùa một cách thô bạo.
A man with a mustache and beard is holding a frying pan that has flames rising from it.	Một người đàn ông với râu ria và râu ria đang cầm một cái chảo mà đã bốc cháy từ nó.	Một người đàn ông có ria mép và râu đang cầm một chiếc chảo rán có ngọn lửa bốc lên.
A man, wearing revolutionary period clothes, is ringing a bell.	Một người đàn ông, mặc quần áo thời gian, là một tiếng chuông.	Một người đàn ông mặc trang phục thời cách mạng đang rung chuông.
A man in a black shirt fishing on a rocky shore.	Một người đàn ông mặc sơ mi đen trên bờ biển.	Một người đàn ông mặc áo sơ mi đen đang câu cá trên bờ đá.
Two dogs are nuzzling each other nose to nose.	Hai con chó đang mổ mũi nhau.	Hai con chó đang dụi mũi vào nhau.
Two men stop to chat on the sidewalk as a car passes by.	Hai người đàn ông dừng lại để trò chuyện trên vỉa hè như một chiếc xe đi ngang qua.	Hai người đàn ông dừng lại trò chuyện trên vỉa hè khi một chiếc xe chạy qua.
A chinese man sitting down waiting for customers.	Một người đàn ông ngồi chờ khách hàng.	Một người đàn ông Trung Quốc đang ngồi đợi khách.
Parked cars with a school bus behind them.	Đậu xe với xe bus ở trường sau lưng họ.	Những chiếc ô tô đỗ cạnh xe buýt trường học phía sau.
Two woman wearing similar shirts walk to the left.	Hai người phụ nữ mặc áo sơ mi giống hệt nhau đi về bên trái.	Hai người phụ nữ mặc áo sơ mi giống nhau đi về phía bên trái.
A young child wearing an orange life vest holding an oar paddling a blue kayak in a body of water.	Một đứa trẻ mặc áo da màu cam đang cầm một mái chèo trong một vũng nước.	Một đứa trẻ mặc áo phao màu cam đang cầm mái chèo chèo chiếc thuyền kayak màu xanh trong một vùng nước.
People walking on a trail in a tree filled park.	Người ta đi trên một con đường mòn trong một cái cây có nhiều bãi đỗ xe.	Mọi người đang đi bộ trên đường mòn trong một công viên đầy cây xanh.
Three young adults talk in a crowd of people, the woman looks upset.	Ba người trẻ nói chuyện trong đám đông người, người phụ nữ thì buồn bực.	Ba thanh niên đang nói chuyện giữa đám đông, người phụ nữ có vẻ buồn bã.
Woman and child outside the front door of their scenic home.	Và một đứa trẻ ở ngoài cửa trước nhà của họ.	Người phụ nữ và đứa trẻ bên ngoài cửa trước ngôi nhà đẹp như tranh vẽ của họ.
A black man and his two white friends are putting their heads close together.	Một người da đen và hai người bạn da trắng của mình đang kết nối đầu của họ lại với nhau.	Một người đàn ông da đen và hai người bạn da trắng đang chụm đầu lại với nhau.
A girl wearing camouflage pants sits on top of a Hummer.	Một cô gái mặc quần thể thao ngồi trên một chiếc xe tải.	Một cô gái mặc quần rằn ri ngồi trên nóc xe Hummer.
A light brown dog is running up.	Một con chó nâu phát sáng đang chạy lên.	Một con chó màu nâu nhạt đang chạy tới.
A boy poses with a large green insect on his nose.	Một cậu bé với một con côn trùng màu xanh to trên mũi.	Một cậu bé tạo dáng với một con côn trùng xanh lớn trên mũi.
A bald man demonstarting how high his brown and black dog can jump.	Một người đàn ông đàn ông đàn ông đầu ác mộng so với mức độ cao màu nâu và đen con chó có thể nhảy.	Một người đàn ông trọc đầu đang chứng minh chú chó nâu và đen của mình có thể nhảy cao đến mức nào.
A crowd on a busy daytime street.	Một đám đông trên đường phố đông đúc.	Một đám đông trên một con phố đông đúc vào ban ngày.
A muzzled greyhound dog wearing yellow and black is running on the track.	Một con chó săn săn da vàng và đen đang chạy trên đường đua.	Một chú chó săn xám đeo rọ mõm, mặc đồ màu vàng và đen đang chạy trên đường đua.
A man wearing sandals sits on the sidewalk near some bags.	Một người đàn ông mang dép ngồi trên vỉa hè gần một cái túi nào đó.	Một người đàn ông đi dép ngồi trên vỉa hè gần một số túi xách.
A man and a woman are sitting on the base of fence having a conversation.	Một người đàn ông và một người đàn bà đang ngồi trên một góc của hàng rào có một cuộc đối thoại.	Một người đàn ông và một người phụ nữ đang ngồi ở chân hàng rào và trò chuyện.
A kid is looking at coffee machines inside a store.	Một thằng nhóc đang nhìn vào máy bán cà phê bên trong một cửa hàng.	Một đứa trẻ đang xem máy pha cà phê bên trong một cửa hàng.
A man drinking out of a yellow cup around people at a busy event	Một người đàn ông uống rượu ra khỏi một chiếc cốc màu vàng xung quanh xung quanh người tại một buổi lễ bận rộn	Một người đàn ông uống từ một chiếc cốc màu vàng xung quanh mọi người tại một sự kiện đông đúc
A boy is leaning on a car with flowers on the hood.	Một cậu bé đang dựa vào một chiếc xe có hoa trên mũ trùm đầu.	Một cậu bé đang dựa vào chiếc xe có hoa trên mui xe.
A woman in a floral dress talks to children in front of a van.	Một người phụ nữ mặc váy hoa hồng nói chuyện với trẻ em trước một chiếc xe tải.	Một người phụ nữ mặc váy hoa đang nói chuyện với trẻ em trước một chiếc xe tải.
A man on his wedding day.	Một người đàn ông vào ngày cưới.	Một người đàn ông trong ngày cưới của mình.
A young woman with a black shirt and jeans sweeping.	Một phụ nữ trẻ với một cái áo sơ mi đen và quần lót.	Một phụ nữ trẻ mặc áo sơ mi đen và quần jean đang quét dọn.
Woman with a hat on climbing a cliff near a large body of water.	Phụ nữ với một chiếc mũ leo lên vách đá gần một hồ nước lớn.	Người phụ nữ đội mũ đang leo lên vách đá gần một vùng nước lớn.
A big black poodle running on the grass with a toy in its mouth.	Một con cá mập đen lớn chạy trên cỏ với một đồ chơi trong miệng.	Một chú chó xù đen lớn đang chạy trên cỏ với một món đồ chơi trong miệng.
A boy in shorts doing a skateboard trick.	Một thằng nhóc mặc quần đùi đang chơi trò lừa đảo.	Một cậu bé mặc quần short đang biểu diễn trò trượt ván.
A little boy dressed in red pants is standing in the street.	Một cậu bé mặc quần đỏ đang đứng trên đường.	Một cậu bé mặc quần đỏ đang đứng trên phố.
A woman texts on her phone while surrounded by umbrellas.	Một phụ nữ trên điện thoại của cô ấy bị bao quanh bởi những cái ô cửa.	Một người phụ nữ đang nhắn tin trên điện thoại trong khi xung quanh có nhiều ô.
Eight men play instruments on stage, with a guitarist highlighted in lights.	Tám người đàn ông chơi nhạc cụ trên sân khấu, với một nhạc sĩ nổi tiếng trong ánh sáng.	Tám người đàn ông chơi nhạc cụ trên sân khấu, với một nghệ sĩ guitar nổi bật trên nền đèn.
A man in an orange jumpsuit and matching hard hat is helping with a blue hose	Một người đàn ông trong một người đàn ông mặc áo lễ màu cam mặc quần áo và phù hợp với mũ là giúp đỡ với một vòi nước	Một người đàn ông mặc bộ đồ liền quần màu cam và đội mũ bảo hiểm phù hợp đang giúp đỡ bằng ống màu xanh
A man and two girls show off a fish while holding fishing poles in front of a body of water.	Một người đàn ông và hai cô gái khoe một con cá trong khi đang mang gậy đánh cá ở phía trước một hồ nước.	Một người đàn ông và hai cô gái đang giơ một con cá trong khi cầm cần câu trước một vùng nước.
Man in red shirt watches dog on an agility course.	Người đàn ông mặc áo sơ mi màu đỏ đồng hồ trên một đường đua.	Người đàn ông mặc áo sơ mi đỏ đang theo dõi chú chó trên đường đua vượt chướng ngại vật.
A boy wearing red and white swimming trunks diving backwards in a beautiful pool.	Một chàng trai mặc quần bơi màu đỏ trắng và trắng sau lưng trong một hồ bơi đẹp đẽ.	Một cậu bé mặc quần bơi màu đỏ và trắng đang lặn ngửa trong một hồ bơi tuyệt đẹp.
An Asian woman pinning her hair back.	Một phụ nữ tóc giả.	Một phụ nữ châu Á đang buộc tóc ra sau.
An older woman and a young child in a pink shirt playing with multicolored blocks.	Một người đàn bà lớn tuổi và một đứa trẻ mặc áo sơ mi màu hồng đang chơi với nhiều khối.	Một phụ nữ lớn tuổi và một đứa trẻ mặc áo sơ mi hồng đang chơi với những khối hình nhiều màu.
A small black dog jumping over gates	Một em gái nhỏ da đen, người phụ	Một con chó đen nhỏ nhảy qua cổng
A brown-haired man in a green shirt plays a trumpet outdoors.	Một người đàn ông tóc nâu mặc áo sơ mi màu xanh thổi kèn kèn.	Một người đàn ông tóc nâu mặc áo sơ mi xanh đang chơi kèn trumpet ngoài trời.
A man talks on the phone with his feet up.	Một người đàn ông nói chuyện điện thoại với đôi chân giơ lên.	Một người đàn ông đang nói chuyện điện thoại với đôi chân giơ lên.
A group of children sit on a blue mat while they eat out of bowls.	Một nhóm trẻ em ngồi trên một tấm thảm xanh trong khi chúng ăn trong bát.	Một nhóm trẻ em ngồi trên tấm thảm màu xanh trong khi ăn trong bát.
A black boy is sitting in the sand.	Một cậu bé da đen đang ngồi trên cát.	Một cậu bé da đen đang ngồi trên cát.
A small dog watches two big dogs playing rough in a field.	Một con chó nhỏ đang chơi hai con chó đẻ đang chơi đùa trên cánh đồng.	Một chú chó nhỏ đang quan sát hai chú chó lớn đang chơi đùa thô bạo trên cánh đồng.
People sitting in a circle outside a large building.	Người ngồi trong một vòng tròn bên ngoài một tòa nhà lớn.	Mọi người ngồi thành vòng tròn bên ngoài một tòa nhà lớn.
One dog leaps to catch a softball while another looks on.	Một con chó muốn bắt một con trong khi một con chó khác nhìn thấy.	Một con chó nhảy lên để bắt một quả bóng mềm trong khi con chó khác đứng nhìn.
A blond child swinging on a swing.	Một cô gái tóc vàng đang đung đưa.	Một đứa trẻ tóc vàng đang đu đưa trên xích đu.
One man and two women having a discussion over white wine	Một người hai vợ hai vợ chồng đã bàn bạc về rượu trắng	Một người đàn ông và hai người phụ nữ đang thảo luận về rượu vang trắng
An Asian man is cooking food outdoors.	Một người đàn ông là nấu ăn thực phẩm.	Một người đàn ông Châu Á đang nấu ăn ngoài trời.
A brown dog about to catch a green Frisbee.	Một con chó nâu chuẩn bị bắt một con cá tuyết xanh.	Một chú chó nâu chuẩn bị bắt một chiếc đĩa Frisbee màu xanh lá cây.
Fans cheer as the band plays a song.	Cổ vũ khi ban nhạc hát một bài hát.	Người hâm mộ reo hò khi ban nhạc chơi một bài hát.
A young boy is standing next to a sand sculpture of a pyramid.	Một cậu bé đang đứng cạnh một tảng cát của kim tự tháp.	Một cậu bé đang đứng cạnh một tác phẩm điêu khắc bằng cát hình kim tự tháp.
Three young children are walking through a grassy yard.	Ba đứa trẻ đang bước đi trong một bãi cỏ.	Ba đứa trẻ đang đi bộ qua một sân cỏ.
A man pounds on an artwork perched on a cart.	Một người đàn ông đánh một cú đá trên một chiếc xe tải.	Một người đàn ông đang đập mạnh vào tác phẩm nghệ thuật được đặt trên xe đẩy.
A man on a bicycle rides on a mountain.	Một người đàn ông đi xe đạp trên một ngọn núi.	Một người đàn ông đang đạp xe trên núi.
A boy with blue and yellow rain boots runs on dirt.	Một cậu bé với đôi giày mưa xanh và màu vàng trên đất.	Một cậu bé đi ủng đi mưa màu xanh và vàng đang chạy trên đất.
A woman in an orange jacket sits on a bench.	Một người phụ nữ mặc áo khoác màu vàng ngồi trên ghế dài.	Một người phụ nữ mặc áo khoác màu cam đang ngồi trên băng ghế.
A man doing a trick on skateboard	♪ Một người đàn ông đang làm một cuộc phiêu	Một người đàn ông đang biểu diễn một trò ảo thuật trên ván trượt
A man in a martial arts uniform in midair.	Một người đàn ông trong bộ quân phục võ thuật.	Một người đàn ông mặc đồng phục võ thuật đang ở giữa không trung.
Woman selling bags of fruit on a sidewalk.	Bán một gói hoa quả trên một vỉa hè.	Người phụ nữ bán túi trái cây trên vỉa hè.
Two soccer teams are on the field.	2 đội đang trên sân bóng.	Có hai đội bóng đá trên sân.
A child in a blue shirt jumping off a bench.	Một đứa trẻ mặc áo xanh nhảy ra khỏi ghế dài.	Một đứa trẻ mặc áo sơ mi xanh đang nhảy từ trên băng ghế xuống.
A goalie in a yellow field is protecting the goal.	Mục tiêu trong sân bóng là bảo vệ mục tiêu.	Một thủ môn trong sân màu vàng đang bảo vệ khung thành.
A group of young people take shots in a Mexican setting.	Một nhóm thanh niên bị bắn trong một môi trường của người Mê-hi-cô.	Một nhóm thanh niên đang chụp ảnh trong bối cảnh Mexico.
A young man skateboards off a pink railing.	Một người đàn ông trẻ tuổi không chịu nổi đau đớn.	Một chàng trai trẻ đang trượt ván trên lan can màu hồng.
A young boy jumping from a bunk bed on a smaller bed.	Một cậu bé nhảy từ giường ngủ trên giường nhỏ.	Một cậu bé nhảy từ giường tầng sang một chiếc giường nhỏ hơn.
Two people wearing odd alien-like costumes, one blue and one purple, are standing in a road.	Hai người mặc bộ đồ kiểu người ngoài hành tinh, một màu xanh và một màu tím, đang đứng trên một con đường.	Hai người mặc trang phục kỳ lạ giống người ngoài hành tinh, một người màu xanh và một người màu tím, đang đứng trên đường.
Man running wearing a blue shirt with a number taped to it.	Người đàn ông mặc áo sơ mi màu xanh có ghi số của nó.	Người đàn ông đang chạy, mặc chiếc áo sơ mi xanh có dán số áo.
An Asian factory worker posing for the camera.	Một công nhân nhà máy làm việc cho máy quay.	Một công nhân nhà máy người Châu Á đang tạo dáng trước ống kính.
A man that appears to be running in a marathon gives us 2 thumbs up.	Một người đàn ông xuất hiện trong một đua xe cho chúng tôi 2 bước lên.	Một người đàn ông trông giống như đang chạy marathon và giơ 2 ngón tay cái lên.
Basketball players shoot for a goal during a game.	Cầu thủ bóng rổ bắn trúng đích trong một trận đấu.	Các cầu thủ bóng rổ đang ném bóng vào rổ trong một trận đấu.
A football player wearing an orange uniform smiling and holding the football.	Một cầu thủ bóng bầu dục mặc đồng phục màu cam mỉm cười và nắm giữ bóng bầu dục.	Một cầu thủ bóng đá mặc đồng phục màu cam đang mỉm cười và cầm quả bóng.
Two downhill skateboarders round a curve while others watch.	Hai cầu thủ vòng quanh một đường cong trong khi những người khác xem.	Hai người trượt ván xuống dốc quanh một khúc cua trong khi những người khác đứng xem.
A team in white and gold on the sidelines of a football field.	Một đội bóng trắng và vàng trên mặt trận sân bóng đá.	Một đội mặc trang phục trắng và vàng đứng bên lề sân bóng đá.
A little girl is pushing her scooter through a grassy tree lined field.	Một cô bé đang bước qua một cánh đồng cỏ đầy cỏ.	Một bé gái đang đẩy chiếc xe tay ga của mình qua một cánh đồng cỏ có hàng cây xanh.
Group of asian children dressed in white shirts and hats performing with a crowd looking on.	Một nhóm trẻ em theo đạo Do Thái mặc áo sơ mi trắng và mặc áo sơ mi trắng và ăn mặc với một đám đông đang ngắm nhìn.	Một nhóm trẻ em châu Á mặc áo sơ mi trắng và đội mũ biểu diễn trước sự chứng kiến ​​của đám đông.
Pedestrians walking down the street look at a child in a cardboard box.	Những người đi bộ trên đường nhìn vào một đứa trẻ trong một cái hộp.	Người đi bộ trên phố nhìn vào một đứa trẻ trong hộp các tông.
A brown dog runs down the sandy beach.	Một con chó nâu chạy dọc theo bãi cát.	Một chú chó nâu chạy dọc bãi biển đầy cát.
Two men in army uniforms stand next to a woman.	Hai người đàn ông trong quân đội đứng cạnh một phụ nữ.	Hai người đàn ông mặc quân phục đứng cạnh một người phụ nữ.
The Dali Lama during a reception where participants have brought carnations, parasols and prayer flags.	Đại hội Dali trong buổi tiệc chiêu đãi, nơi những người tham gia đã mang đến những ca-lo, ô-rê và cờ cầu nguyện.	Đức Đạt Lai Lạt Ma trong một buổi tiếp tân, nơi những người tham dự mang theo hoa cẩm chướng, ô và cờ cầu nguyện.
A biker jumps an obstacle.	Một chiếc xe đạp lao vào một trở ngại.	Một người đi xe đạp vượt qua chướng ngại vật.
A couple sitting in white lawn chairs are smiling at the camera.	Một cặp vợ chồng ngồi trên ghế trắng đang cười với máy quay.	Một cặp đôi đang ngồi trên ghế xếp màu trắng và mỉm cười với ống kính máy ảnh.
Young kids are on a small train ride.	Trẻ em đang đi trên một con tàu nhỏ.	Những đứa trẻ đang đi trên một chuyến tàu nhỏ.
A surfer in a blue swimsuit is riding the waves.	Aer trong một màu xanh nước biển là lướt sóng.	Một người lướt sóng trong bộ đồ bơi màu xanh đang lướt sóng.
The boy jumps onto his soccer player brother.	Cậu bé nhảy vào cầu thủ bóng đá của mình người anh em.	Cậu bé nhảy lên người anh trai là cầu thủ bóng đá của mình.
Two young men on opposing soccer teams are competing to get the ball on a soccer field.	Hai chàng trai trẻ trong đội bóng đá đang thi đấu để có bóng trên sân bóng đá.	Hai chàng trai trẻ của hai đội bóng đá đối địch đang tranh giành quả bóng trên sân bóng.
People are walking on a paved slope surrounded by Chinese vendors.	Mọi người đang đi bộ trên một tảng đá được bao quanh bởi những người Trung Quốc.	Mọi người đang đi bộ trên một con dốc lát đá được bao quanh bởi những người bán hàng Trung Quốc.
A young boy wearing white pants is jumping off the couch.	Một chàng trai trẻ mặc quần trắng đang nhảy khỏi ghế.	Một cậu bé mặc quần trắng đang nhảy khỏi ghế sofa.
A boy in an orange shirt is pouring Legos from a bag.	Một cậu bé mặc áo sơ mi màu cam đang hút thuốc trong một cái túi.	Một cậu bé mặc áo sơ mi màu cam đang đổ Lego từ trong túi ra.
Woman wearing brown sandals and blue jeans, in a white shirt, holding a baby under a tall tree.	Đàn bà mang giày nâu và quần jean xanh, mặc áo sơ mi trắng, ôm em bé dưới chân cây cao.	Người phụ nữ đi dép xăng đan màu nâu và quần jean xanh, mặc áo sơ mi trắng, đang bế một đứa bé dưới một gốc cây cao.
Three people smiling and holding political signs.	Ba người mỉm cười và giữ những biểu hiện chính trị.	Ba người mỉm cười và cầm biểu ngữ chính trị.
An officer stands next to a car on a city street.	Một sĩ quan đứng cạnh một chiếc xe trên đường phố.	Một cảnh sát đứng cạnh một chiếc ô tô trên phố.
Two men wearing hats.	Hai người đàn ông đội mũ.	Hai người đàn ông đội mũ.
A boy in midair trying to kick a soccer ball	Một cậu bé đang cố đá bóng	Một cậu bé đang ở giữa không trung cố gắng đá một quả bóng đá
A young boy with a blue beanie has his head down.	Một chàng trai trẻ với một cục đậu xanh đang cúi đầu xuống.	Một cậu bé đội mũ len màu xanh đang cúi đầu.
A red-haired man with dreadlocks is sitting playing and acoustic guitar.	Một người đàn ông tóc đỏ với hoa dại đang ngồi chơi và âm thanh guitar.	Một người đàn ông tóc đỏ với mái tóc tết đang ngồi chơi đàn guitar acoustic.
A man eating a sandwich with his baby daughter in his lap.	Một người đàn ông đang ăn sandwich với đứa con gái nhỏ trên đùi.	Một người đàn ông đang ăn bánh sandwich với cô con gái nhỏ ngồi trên đùi.
An African American child is holding something up that those in the picture are proud of.	Một đứa trẻ người Mỹ đang giơ lên một cái gì đó mà trong bức tranh đang tự hào.	Một đứa trẻ người Mỹ gốc Phi đang cầm một vật gì đó mà những người trong ảnh cảm thấy tự hào.
A woman directs a crowd of people with a loudspeaker.	Một người đàn bà nói lớn tiếng với đám đông.	Một người phụ nữ đang chỉ đạo đám đông bằng loa phóng thanh.
Costumed onlookers watch as a uniformed policeman makes a speech and a man in a suit holds a bowl of fruit.	Coi chừng như một cảnh sát mặc quân phục làm cho một bài phát biểu và một người đàn ông trong bộ vest đặt một bát trái cây.	Những người xem mặc trang phục hóa trang theo dõi một cảnh sát mặc đồng phục phát biểu và một người đàn ông mặc vest cầm một bát trái cây.
A crowd is present at a bar.	Một đám đông có mặt tại một quán rượu.	Một đám đông đang có mặt tại một quán bar.
A girl in white and a girl in green walk past a blue car wash station.	Một cô gái mặc đồ trắng và một cô gái mặc áo xanh bước qua một trạm rửa xe màu xanh.	Một cô gái mặc đồ trắng và một cô gái mặc đồ xanh lá cây đi ngang qua một trạm rửa xe màu xanh.
A man is using electronic equipment.	Một người đàn ông đang sử dụng thiết bị điện tử.	Một người đàn ông đang sử dụng thiết bị điện tử.
A person surfing through a crashing wave in the ocean.	Một con người xuyên qua làn sóng trong đại dương.	Một người đang lướt qua một con sóng dữ dội trên đại dương.
An army officer is inspecting something.	Một sĩ quan quân đội đang chuẩn bị gì đó.	Một sĩ quan quân đội đang kiểm tra một thứ gì đó.
A bride and groom kiss under the bride's veil.	Một cô dâu và một nụ hôn hồng dưới khăn choàng của cô dâu.	Cô dâu và chú rể hôn nhau dưới tấm mạng che mặt của cô dâu.
Riot police are standing in the background while a young man with a red scarf covering his face is walking.	Cảnh sát đang đứng trên sân sau trong khi một thanh niên đeo khăn choàng đỏ che mặt đang đi.	Cảnh sát chống bạo động đang đứng ở phía sau trong khi một thanh niên đeo khăn quàng đỏ che mặt đang bước đi.
A black and white dog jumping over a steeple vault at a competition	Một người da đen trắng trắng da đen, da da màu trắng trắng da màu màu da da màu, da màu màu màu màu màu da trắng, da màu màu trắng da màu, da màu màu màu màu màu da trắng da màu, da màu màu màu màu da trắng da màu màu màu màu màu màu màu màu màu màu màu màu màu da trắng, da màu màu màu màu màu màu màu màu màu màu màu màu màu màu màu màu da trắng, da màu da trắng da trắng da trắng da màu da trắng da trắng, nhảy nhảy hơn hơn hơn hơn hơn hơn hơn hơn hơn hơn hơn hơn hơn hơn hơn hơn hơn hơn hơn hơn hơn hơn hơn hơn hơn hơn hơn hơn hơn hơn hơn hơn hơn hơn đồng cờ mùa mùa mùa mùa mùa vào vào vào vào vào vào vào vào vào vào vào vào vào vào vào vào vào vào vào vào vào vào vào vào vào vào vào vào vào vào vào vào vào vào vào vào vào vào vào vào vào vào vào vào vào vào vào vào vào vào vào vào vào vào vào vào vào vào vào vào vào vào vào vào vào vào vào vào vào vào vào vào vào vào vào vào vào vào vào vào vào vào vào vào vào vào vào vào vào vào vào vào vào vào vào vào vào vào vào vào vào vào vào vào vào vào vào vào vào vào vào giải giải giải giải giải tại tại tại tại tại tại tại tại tại tại tại tại tại tại tại tại tại tại tại tại tại tại tại tại tại tại tại tại tại tại tại tại tại tại tại tại tại tại tại tại tại tại tại tại tại tại tại tại tại tại tại tại tại tại tại tại tại tại tại tại tại tại tại tại tại tại tại tại tại tại tại tại tại tại tại tại tại tại tại tại tại tại tại tại tại tại tại tại tại tại tại tại tại tại tại tại tại tại tại vui vui vui vui vui vui vui vui vui vui vui vui vui vui vui	Một chú chó đen trắng nhảy qua một mái vòm trong một cuộc thi
A woman wearing a sweater is reading a book in her home.	Một phụ nữ mặc áo len đang đọc sách ở nhà.	Một người phụ nữ mặc áo len đang đọc sách trong nhà.
Several teenagers are looking over a railing in a dark room.	Nhiều thanh niên đang nhìn qua một đường ngang trong một căn phòng tối.	Một vài thanh thiếu niên đang nhìn qua lan can trong một căn phòng tối.
The man in the white t-shirt is starting to climb a rock.	Người mặc áo thun màu trắng đang bắt đầu lắc lư.	Người đàn ông mặc áo phông trắng đang bắt đầu trèo lên một tảng đá.
A teenage boy is stretching in the kitchen and you can see part of his stomach.	Một cậu bé đang đi dạo trong bếp và bạn có thể thấy một phần dạ dày cậu bé.	Một cậu bé tuổi teen đang duỗi người trong bếp và bạn có thể nhìn thấy một phần bụng của cậu ấy.
People are holding various types of drumsticks above different kinds of drums.	Người ta đang cầm nhiều loại que trống trên nhiều loại trống khác nhau.	Mọi người cầm nhiều loại dùi trống khác nhau đặt trên nhiều loại trống khác nhau.
Three farmers harvest rice out in a rice field.	Ba con lúa được thu hoạch trong một cánh đồng lúa mạch.	Ba người nông dân đang thu hoạch lúa trên một cánh đồng lúa.
Two women and a man are looking at a book.	Hai phụ nữ và một người đàn ông đang nhìn vào một cuốn sách.	Hai người phụ nữ và một người đàn ông đang nhìn vào một cuốn sách.
Three children's legs are shown as they stand near a mess of silly string.	Chân của ba đứa trẻ được thể hiện khi chúng đứng gần một đống dây ngớ ngẩn.	Trong ảnh là đôi chân của ba đứa trẻ đang đứng gần một mớ dây thừng ngớ ngẩn.
A cook is posing for a camera while cooking.	Nấu nướng là để làm máy quay trong thời gian đó.	Một đầu bếp đang tạo dáng trước ống kính máy ảnh trong khi nấu ăn.
Many people in a street protesting the use of coal in power plants.	Nhiều người trên một đường phố phản đối việc sử dụng than đá trong các nhà máy điện.	Nhiều người dân trên phố phản đối việc sử dụng than trong các nhà máy điện.
The teen jumps the hill with his bicycle.	Các thanh niên nhảy lên đồi với chiếc xe đạp của mình.	Cậu thiếu niên nhảy xuống đồi bằng xe đạp.
A little girl running at on the shore of a beach.	Một bé gái chạy trên bờ biển.	Một bé gái đang chạy trên bờ biển.
White duck flapping its wings in the water.	Con vịt trắng chiên đôi cánh của nó trong nước.	Vịt trắng vỗ cánh trong nước.
Two males seem to be conversing while standing in front of a truck's back, and behind a metal item, while four people stand around them.	Hai người đàn ông có vẻ như đang đứng trước một chiếc xe tải, và đằng sau một miếng kim loại, trong khi bốn người đứng xung quanh họ.	Hai người đàn ông dường như đang trò chuyện trong khi đứng trước thùng xe tải và đằng sau một vật kim loại, trong khi bốn người đứng xung quanh họ.
A woman in a pink skirt is holding a baby.	Một người phụ nữ mặc váy hồng đang ôm em bé.	Một người phụ nữ mặc váy hồng đang bế một đứa bé.
A hockey player in a yellow jersey is guarding the goal.	Một cầu thủ bóng chày đang ngắm mục tiêu.	Một cầu thủ khúc côn cầu mặc áo vàng đang bảo vệ khung thành.
A man is walking past a large sign that says E.S.E. Electronics.	Một người đang vượt qua một biển báo lớn ghi là E.S.E.	Một người đàn ông đang đi ngang qua một biển báo lớn có ghi chữ E.S.E. Electronics.
Three boys wearing green shirts and tan pants pose at the top of a slide.	Ba thằng con trai mặc áo sơ mi xanh và mặc quần rám nắng ở đỉnh của ván trượt.	Ba cậu bé mặc áo sơ mi xanh và quần nâu tạo dáng ở đầu cầu trượt.
A man is dancing with a dog between his legs.	Một người đàn ông đang giao du với một con chó giữa hai chân của mình.	Một người đàn ông đang nhảy múa với một chú chó giữa hai chân.
The white dog is running in the shallow water.	Con chó trắng đang chảy trong nước biển.	Con chó trắng đang chạy trong vùng nước nông.
Oregon percussionists are marching with the band.	Các nhà tư pháp đang tiến hành cùng với ban nhạc.	Các nghệ sĩ chơi nhạc cụ gõ của Oregon đang diễu hành cùng ban nhạc.
A group of children play together in a fenced yard as an adult watches.	Một nhóm trẻ em chơi chung trong sân khi đang xem đồng hồ.	Một nhóm trẻ em đang chơi đùa cùng nhau trong một sân có hàng rào dưới sự quan sát của một người lớn.
A group of women are playing musical instruments together.	Một nhóm phụ nữ đang cùng nhau chơi nhạc cụ.	Một nhóm phụ nữ đang cùng nhau chơi nhạc cụ.
A little girl in a purple plaid dress is lying on the floor crying.	Một cô gái nhỏ trong một y phục màu tím màu tím nằm trên sàn khóc.	Một bé gái mặc váy kẻ caro màu tím đang nằm khóc trên sàn.
A man with graying hair shaves his beard.	Một người đàn ông tóc bạc cạo râu cạo râu.	Một người đàn ông tóc hoa râm đang cạo râu.
Two black dogs, a black puppy, and a white dog in the snow.	Hai con chó đen, một con chó đen, và một con chó trắng trong tuyết.	Hai con chó đen, một con chó con đen và một con chó trắng trên tuyết.
Man in a Miami basketball uniform jumping to make a shot.	Người đàn ông mặc đồng phục bóng rổ để làm cho một shot.	Người đàn ông mặc đồng phục bóng rổ Miami nhảy lên để thực hiện cú ném.
A woman is sitting outside her house with a blue door, enjoying the air.	Một người đờn bà ngồi bên ngoài nhà mình, với một cái cửa màu xanh, hưởng bầu không khí.	Một người phụ nữ đang ngồi bên ngoài ngôi nhà có cánh cửa màu xanh, tận hưởng không khí trong lành.
Kids are sitting on a man in a banana suit.	Trẻ con đang ngồi trên một người đàn ông mặc đồ vest.	Những đứa trẻ đang ngồi trên một người đàn ông mặc bộ đồ hình quả chuối.
A gray and white dog jumping over standing water in the sand.	Một con chó trắng trắng nhảy qua đứng nước trong cát.	Một chú chó màu xám và trắng nhảy qua vũng nước đọng trên cát.
A crowd gathered around a park water fountain in the rain.	Một đám đông tụ tập xung quanh một hồ nước trong mưa.	Một đám đông tụ tập quanh đài phun nước trong công viên dưới trời mưa.
Several older men, some in traditional headdress convene on a street corner.	Những người đàn ông lớn tuổi, một số trong truyền thống ông đã đi qua một góc phố.	Một số người đàn ông lớn tuổi, một số đội mũ truyền thống, tụ tập ở một góc phố.
A young Lassie looking dog is in the snow.	Một chú chó nhìn gái trẻ đang chìm trong tuyết.	Một chú chó giống Lassie đang ở trong tuyết.
The soccer player wearing the gold jersey is blocking the ball from the opposing team player.	Cầu thủ bóng đá đeo huy hiệu vàng đang chặn bóng từ cầu thủ bóng đá.	Cầu thủ bóng đá mặc áo vàng đang chặn bóng từ cầu thủ đội đối phương.
A woman in a black shirt is knitting with purple yarn.	Một người phụ nữ mặc áo sơ mi đen là có màu tím.	Một người phụ nữ mặc áo sơ mi đen đang đan len màu tím.
Four females of Asian descent are wearing golden dresses while performing point ballet.	Bốn người gốc Tây Ban Nha mặc áo hoàng kim trong khi biểu diễn.	Bốn cô gái gốc Á mặc váy vàng trong khi biểu diễn múa ba lê.
A person is playing an unique instrument.	Một người đang chơi một công cụ độc đáo.	Một người đang chơi một nhạc cụ đặc biệt.
A girl wearing black athletic clothing with the number 1102 on her jersey runs across some grass.	Một cô gái mặc đồ thể thao màu đen với số 1102 trên áo ngực của mình lướt qua cỏ.	Một cô gái mặc quần áo thể thao màu đen có số 1102 trên áo đang chạy qua bãi cỏ.
"A kid crosscountry skis wearing the number ""93""."	"Một thằng nhóc chơi trò trượt tuyết với con số ""93""."	"Một đứa trẻ trượt tuyết xuyên quốc gia mặc áo số ""93""."
A older gentleman and a young girl begin to work on a puzzle together.	Một người đàn ông lớn tuổi và một cô gái trẻ bắt đầu làm việc trên một câu đố với nhau.	Một ông già và một cô gái trẻ bắt đầu cùng nhau giải một câu đố.
A film crew films a young African boy in a yellow shirt.	Một bộ phim quay một cậu bé Châu Phi mặc áo vàng.	Một đoàn làm phim đang quay phim một cậu bé người Châu Phi mặc áo sơ mi vàng.
A streetlight lit bridge with a cyclist and some cars.	Một chuyến đi dạo với một chiếc xe đạp và vài chiếc xe hơi.	Một ngọn đèn đường chiếu sáng cây cầu cùng với một người đi xe đạp và một số ô tô.
A man rides a kicking bull in a bullpen.	Một người cưỡi một con trâu bò.	Một người đàn ông đang cưỡi một con bò đực đang đá trong chuồng bò.
A boy jumping to hit a tennis ball with his racket	♪ A boy để đánh một trận bóng bóng đá với tiền của mình ♪	Một cậu bé nhảy lên để đánh một quả bóng tennis bằng vợt của mình
Kids scale a wall as two other people watch.	Trẻ em leo tường như hai người khác xem.	Trẻ em trèo tường trong khi hai người khác đứng nhìn.
People walking about a university campus with palm trees in the background.	Những người đi bộ về một trường đại học với những cây cọ ở phía sau.	Mọi người đi bộ quanh khuôn viên trường đại học với những cây cọ ở phía sau.
Little girl kicks black object at karate class.	Một bé gái đá bóng vào lớp.	Cô bé đá một vật màu đen trong lớp học karate.
Two men trying to hoist themselves up from the water on to a walkway made of tires.	Hai người đàn ông đang cố gắng để tự nâng mình lên từ nước trên một đường đi bộ của lốp xe.	Hai người đàn ông đang cố gắng kéo mình lên khỏi mặt nước để đi trên lối đi làm bằng lốp xe.
Two men breakdancing, with a crowd looking on.	Hai người đàn ông nhảy nhót, với một đám đông nhìn chằm chằm.	Hai người đàn ông đang nhảy breakdance trước sự chứng kiến ​​của đám đông.
A professionally dressed woman standing at a podium debating or discussing something of importance.	Một người đàn bà ăn mặc nhã nhặn đứng trước một cuộc tranh cãi hoặc bàn luận về một điều gì đó có tầm quan trọng.	Một người phụ nữ ăn mặc chuyên nghiệp đang đứng trên bục tranh luận hoặc thảo luận về một điều gì đó quan trọng.
A woman is laying down on a sofa laughing.	Một người phụ nữ đang ngồi trên một cái bệ cười.	Một người phụ nữ đang nằm trên ghế sofa và cười.
A dirt floor gets swept by one white and one black woman.	Tầng đất bị một phụ nữ da trắng và một phụ nữ da đen quét sạch.	Một người phụ nữ da trắng và một người phụ nữ da đen đang quét sàn đất.
A deer jumps a fence.	Một con nai nhảy qua hàng rào.	Một con hươu nhảy qua hàng rào.
Three dogs play with each other out in the field.	Những con chó chơi với nhau trên chiến trường.	Ba con chó đang chơi đùa với nhau ở ngoài cánh đồng.
Two young children are on sand.	Hai đứa trẻ đang ở trên cát.	Hai đứa trẻ đang ở trên cát.
A smiling young boy plays in the leaves among the ducks.	Một chàng trai trẻ mỉm cười chơi trong những cái lá giữa những con vịt.	Một cậu bé tươi cười đang chơi đùa giữa đám lá cây giữa đàn vịt.
These four people are standing outdoors, with 3 dogs.	Bốn người này đang đứng bên ngoài, với 3 con chó.	Bốn người này đang đứng ngoài trời, cùng với 3 con chó.
While visiting the Mayan ruins, a guide points in the direction of more attractions.	Trong khi đi thăm tàn tích, một điểm dẫn đầu hướng đến nhiều sự thu hút hơn.	Khi tham quan di tích của người Maya, hướng dẫn viên sẽ chỉ đường đến nhiều điểm tham quan hơn.
Girl wearing radio t-shirt has open mouth	#############i khi mở nhạc##	Cô gái mặc áo phông radio há miệng
A tribal group filling water jugs in the desert.	Một nhóm nước tràn ngập trong sa mạc.	Một nhóm bộ lạc đang lấy đầy bình nước trong sa mạc.
A man standing on a city street.	Một người đàn ông đang đứng trên một đường phố.	Một người đàn ông đang đứng trên phố.
A flock of birds fly away with food in their beaks.	Một bầy chim bay mất với đồ ăn trong mình nó.	Một đàn chim bay đi với thức ăn trong mỏ.
Two men ride through farm land as they guide their mule powered trailer.	Hai người đàn ông đi ngang qua vùng đất nông trại khi họ lái xe tải của họ.	Hai người đàn ông đi qua trang trại trong khi kéo chiếc xe kéo do lừa kéo.
Two people stand at the peak of a mountain.	Hai người đứng trên đỉnh núi.	Hai người đứng trên đỉnh núi.
Young girl enjoying herself as she makes a snow angel.	Một cô gái trẻ đang tận hưởng khi cô ấy tạo ra một thiên thần tuyết.	Cô bé thích thú khi nặn thiên thần tuyết.
Three guys smiling for camera and showing off their muscles.	Ba anh chàng đang cười với máy ảnh và khoe khoang cơ bắp của mình.	Ba chàng trai mỉm cười trước ống kính và khoe cơ bắp.
A person is writing on a chalkboard in a empty classroom.	Một người đang viết trên bảng trong một trường hợp trống.	Một người đang viết lên bảng đen trong một lớp học trống.
A man in a black shirt sitting at a table with an open Apple laptop in front of him.	Một người đàn ông trong một chiếc áo sơ mi đen ngồi trên bàn với một nắp mở mở trước mặt anh ta.	Một người đàn ông mặc áo sơ mi đen đang ngồi ở bàn với chiếc máy tính xách tay Apple đang mở trước mặt.
Four people relaxing on a grassy hill overlooking a rocky valley.	Bốn người đang nằm trên một ngọn đồi xanh, trên một thung lũng.	Bốn người đang thư giãn trên một ngọn đồi cỏ nhìn xuống một thung lũng đá.
A boy with a skateboard if jumping in the air along some railway tracks.	Một cậu bé với một cái ván trượt nếu nhảy lên không trung dọc theo một số đường ray.	Một cậu bé với chiếc ván trượt đang nhảy trên không dọc theo đường ray xe lửa.
There is a man in an orange shirt playing tennis.	Có một người đàn ông trong một cái áo thun đang chơi tennis.	Có một người đàn ông mặc áo sơ mi màu cam đang chơi quần vợt.
The dog with the red collar is bearing its teeth at the dog with the blue collar.	Con chó với cái vòng cổ màu đỏ đang mang hàm hàm hàm hàm răng của nó trên con chó với cái vòng cổ màu xanh.	Con chó đeo vòng cổ màu đỏ đang nhe răng với con chó đeo vòng cổ màu xanh.
The boy is outside enjoying a summer day.	Cậu bé đang ở ngoài trời nghỉ hè.	Cậu bé đang ở ngoài trời tận hưởng một ngày hè.
A worker in an orange work suit is kneeling down inspecting a piece of machinery.	Một người làm việc trong một bộ đồ màu cam đang giảm thanh tra một phần của máy móc.	Một công nhân mặc bộ đồ bảo hộ màu cam đang quỳ xuống kiểm tra một thiết bị máy móc.
Men in cowboy hats stand around at a rodeo.	Những người đàn ông cao bồi đứng xung quanh tại một đấu trường.	Những người đàn ông đội mũ cao bồi đứng xung quanh một cuộc thi đấu rodeo.
There are two dogs in the snow and one has something in his mouth.	Có hai con chó trong tuyết và một con có gì đó trong miệng nó.	Có hai con chó trên tuyết và một con đang ngậm thứ gì đó trong miệng.
An employee takes a break from working to have a drink	Một nhân viên mất một thời gian nghỉ làm việc để có một ly rượu	Một nhân viên nghỉ làm để uống nước
A beige dog runs behind a white dog holding a yellow toy.	Một con chó đáng yêu chạy phía sau một con chó trắng đang cầm một món đồ chơi màu vàng.	Một chú chó màu be chạy theo một chú chó màu trắng đang cầm một món đồ chơi màu vàng.
Hockey player in white uniform with stick	Đồng ghi đồng ghi đồng màu trắng đồng bộ với đồng	Cầu thủ khúc côn cầu mặc đồng phục màu trắng với cây gậy
Man in a white shirt with a gold watch playing with a circuit board.	Một người mặc áo trắng có một cái đồng hồ vàng chơi với một cái bảng mạch.	Người đàn ông mặc áo sơ mi trắng, đeo đồng hồ vàng đang chơi với bảng mạch điện.
A black horse sticking its head through a fence trying to reach the grass.	Một con ngựa ô thò đầu qua hàng rào cố gắng vươn tới đồng cỏ.	Một con ngựa đen thò đầu qua hàng rào cố gắng với tới bãi cỏ.
A crackhead is pretending to keep his hands warm but actually he is smoking crack.	Một kẻ lập dị giả vờ để giữ cho bàn tay mình ấm áp nhưng thực ra anh ta đang hút thuốc.	Một kẻ nghiện crack giả vờ giữ ấm tay nhưng thực chất là đang hút crack.
Two guys and a girl smiling.	Hai người đàn ông và một cô gái mỉm cười.	Hai chàng trai và một cô gái đang mỉm cười.
A child leans over a display made up of blue and yellow plastic, while an adult looks on.	Một đứa trẻ nghiêng qua một bức màn làm bằng nhựa xanh và vàng, trong khi người lớn nhìn thấy.	Một đứa trẻ đang nghiêng người nhìn vào màn hình được làm bằng nhựa màu xanh và vàng, trong khi một người lớn đang nhìn vào.
A black-and-white dog goes for a flattened ball on the snow.	Một con chó da đen và da trắng đi chơi bóng đá trên tuyết.	Một chú chó đen trắng đang lao vào bắt một quả bóng dẹt trên tuyết.
A young girl standing next to a yellow cat on a kitchen countertop.	Một cô gái trẻ đứng cạnh một con mèo vàng trên một cái bàn bếp.	Một cô gái trẻ đứng cạnh một con mèo vàng trên bệ bếp.
The two kids are playing at the playground.	Hai đứa đang chơi ở sân chơi.	Hai đứa trẻ đang chơi ở sân chơi.
A tennis player in a green striped shirt is holding his hand up to his mouth.	Một tay chơi tennis trong một chiếc áo sọc xanh đang nắm tay lên miệng anh ta.	Một vận động viên quần vợt mặc áo sơ mi sọc xanh đang đưa tay lên miệng.
A boy in a red suit plays in the water.	Một cậu bé mặc đồ màu đỏ chơi trên mặt nước.	Một cậu bé mặc bộ đồ đỏ đang chơi đùa dưới nước.
A child wearing a red coat and cap is holding a large chunk of snow.	Một đứa trẻ mặc áo khoác màu đỏ và nón đang giữ một đống tuyết lớn.	Một đứa trẻ mặc áo khoác đỏ và đội mũ đang cầm một cục tuyết lớn.
Two officers with orange jackets stand outside a white tent with onlookers.	Hai sĩ quan mặc áo khoác màu cam đứng bên ngoài một bức lều trắng với song sắt.	Hai cảnh sát mặc áo khoác màu cam đứng bên ngoài một chiếc lều màu trắng cùng với người dân hiếu kỳ.
Two people standing next to a tree on the ground.	Hai người đứng cạnh một cái cây trên mặt đất.	Hai người đứng cạnh một cái cây trên mặt đất.
Two men sit talking near a stone building.	Hai người đàn ông ngồi nói chuyện với một tòa nhà bằng đá.	Hai người đàn ông ngồi nói chuyện gần một tòa nhà bằng đá.
A brunette child with glasses holding a blond child wearing a red sweater and yellow boots.	Một đứa trẻ đeo kính đeo một đứa trẻ tóc vàng đeo một chiếc áo len màu đỏ và đôi giày màu vàng.	Một đứa trẻ tóc nâu đeo kính đang bế một đứa trẻ tóc vàng mặc áo len đỏ và đi bốt vàng.
A black and white dog is playing with a white ball.	Một con chó trắng đen đang chơi bóng trắng.	Một chú chó đen trắng đang chơi với một quả bóng trắng.
Two people are kissing on a sidewalk in front of a limo while people walk by.	Hai người đang hôn nhau trên một vỉa hè trước mặt một người đi ngang qua.	Hai người đang hôn nhau trên vỉa hè trước một chiếc xe limousine trong khi mọi người đi ngang qua.
A woman is playing volleyball.	Một người phụ nữ đang chơi đùa.	Một người phụ nữ đang chơi bóng chuyền.
Two large dogs are fighting in a dirt field.	Hai con chó lớn đang chiến đấu trên một cánh đồng.	Hai con chó lớn đang đánh nhau trên một cánh đồng đất.
A brown dog jumping over a hurdle.	Một con chó nâu nhảy qua một con.	Một chú chó nâu đang nhảy qua rào chắn.
A man wearing a striped shirt is smoking a cigarette on the street	♪ Một người đàn ông mặc áo sọc thoát y ♪ ♪ ♪ Một người đàn ông mặc áo dài ♪ ♪	Một người đàn ông mặc áo sơ mi kẻ sọc đang hút thuốc trên phố
A little girl is holding a little boy on her lap.	Một bé gái đang ôm một bé trai trong lòng.	Một bé gái đang bế một bé trai trên đùi.
A man trying to ride a very mad bull on a beautiful Saturday afternoon.	Một người đàn ông đang cố gắng để đi một con bò điên vào một buổi chiều đẹp trời buổi chiều.	Một người đàn ông đang cố cưỡi một con bò đực điên cuồng vào một buổi chiều thứ bảy đẹp trời.
Children fight to win a tug-of-war battle.	Trẻ con chiến đấu để chiến thắng trong một trận chiến giữa các trận chiến.	Trẻ em chiến đấu để giành chiến thắng trong trò kéo co.
A cyclist is leaning a mountain bike around a bend on a dirt track.	Một người đi xe đạp đang đi dọc theo một đỉnh núi vòng quanh một khúc cua trên một đường đất.	Một người đi xe đạp đang nghiêng chiếc xe đạp leo núi quanh khúc cua trên đường đất.
Two people and a leashed cow at a home.	Hai người và một con bò cái ở nhà.	Hai người và một con bò bị xích tại một ngôi nhà.
The young boy learns how to ride a bike with his dad.	Cậu bé học cách đi xe đạp với bố nó.	Cậu bé đang học cách đi xe đạp cùng bố.
Boy in red shirt and black shorts sweeps driveway.	Bé trai mặc áo sơ mi đỏ và quần lót đen.	Cậu bé mặc áo sơ mi đỏ và quần short đen đang quét đường lái xe.
An african family are standing in front of some makeshift houses.	Một gia đình người Phi đang đứng trước một số nhà sản xuất.	Một gia đình người Châu Phi đang đứng trước những ngôi nhà tạm bợ.
A man playing an instrument next to a tree.	Một người đàn ông chơi một công cụ kế bên một cây.	Một người đàn ông đang chơi nhạc cụ bên cạnh một cái cây.
Two women are holding hands over a table and smiling at the camera.	Hai phụ nữ cầm tay nhau trên một cái bàn và mỉm cười với máy ảnh.	Hai người phụ nữ nắm tay nhau trên bàn và mỉm cười với ống kính máy ảnh.
A panting brown dog walking on the grass.	Một con chó màu nâu đi bộ trên cỏ.	Một chú chó nâu thở hổn hển đang đi trên bãi cỏ.
A baseball player in a black shirt just tagged a player in a white shirt.	Một cầu thủ bóng chày mặc áo sơ mi đen, chỉ là một cầu thủ mặc áo sơ mi trắng.	Một cầu thủ bóng chày mặc áo sơ mi đen vừa chạm vào một cầu thủ mặc áo sơ mi trắng.
A woman is holding a large check for Kids Food Basket.	Một người phụ nữ đang cầm một tấm séc lớn cho những đứa trẻ thực phẩm Basket.	Một người phụ nữ đang cầm tấm séc lớn dành cho Kids Food Basket.
The two dogs, one with a tennis ball in its mouth, are running through tall grass.	Hai con chó, một với một quả bóng tennis trong miệng nó, đang chạy qua cỏ cao.	Hai con chó, một con ngậm quả bóng tennis trong miệng, đang chạy qua đám cỏ cao.
Two adults and two children sit on a park bench.	Hai người lớn và hai đứa trẻ ngồi trên một cái ghế dài.	Hai người lớn và hai trẻ em ngồi trên băng ghế công viên.
A woman in a grassy field blows on a dandelion.	Một người phụ nữ trên cánh đồng cỏ thổi vào một con chim bồ câu.	Một người phụ nữ đang thổi vào một bông bồ công anh trên cánh đồng cỏ.
A man sells potatoes to a group of people.	Một người đàn ông làm cho một nhóm người.	Một người đàn ông bán khoai tây cho một nhóm người.
A group of people on a street gather together to listen to an accordion.	Một nhóm người trên đường phố tập hợp lại để nghe một lời thề.	Một nhóm người tụ tập trên phố để lắng nghe tiếng đàn accordion.
A man sits on a bench listing to his iPod	♪ Một người đàn ông ngồi trên một đồng xu ♪	Một người đàn ông ngồi trên băng ghế và nghe nhạc từ iPod của mình
An old man on a subway wearing heavy layered clothing is reading a newspaper.	Một người đàn ông già đi tàu điện ngầm mặc quần áo dày đặc đang đọc báo.	Một ông già mặc nhiều lớp quần áo dày đang đọc báo trên tàu điện ngầm.
An older man in glasses is preparing meat.	Một người đàn ông lớn tuổi đeo kính đang chuẩn bị thịt.	Một người đàn ông lớn tuổi đeo kính đang chế biến thịt.
A man performing a trick on a bicycle by standing on the pedals while the bike is upright.	Một người đàn ông làm nghề đánh xe đạp bằng cách đứng trên bàn đạp trong khi xe đạp đang đứng thẳng.	Một người đàn ông đang biểu diễn một trò ảo thuật trên xe đạp bằng cách đứng trên bàn đạp khi xe đạp đang ở trạng thái thẳng đứng.
A man is at the beach making a sand sculpture.	Một người đàn ông đang ở bãi biển làm cát.	Một người đàn ông đang ở bãi biển để tạo ra một tác phẩm điêu khắc bằng cát.
Multiple people in a park eating at a picnic table	♪ Những người trong một công viên ăn tại một bữa tiệc ♪	Nhiều người trong công viên đang ăn ở bàn ăn ngoài trời
Two women are strapped to a tree in some type of construction job.	Có hai phụ nữ dính liền với một cái cây trong một công việc xây dựng nào đó.	Hai người phụ nữ bị trói vào cây trong một công việc xây dựng nào đó.
A cowboy in a rodeo trying to beat the 8 second clock.	Một chàng cao bồi đang cố đánh bại 8 giây.	Một chàng cao bồi trong một cuộc thi đấu rodeo đang cố gắng vượt qua mốc thời gian 8 giây.
A dog is jumping through a fiery obstacle.	Một con chó nhảy qua một cục máu lửa.	Một con chó đang nhảy qua một chướng ngại vật đang bốc cháy.
An overweight woman with long black hair in a pink shirt with a name tag is applying lipstick.	Một người phụ nữ có mái tóc dài màu đen trong một chiếc áo sơ mi màu hồng với một nhãn tên là phù hợp với nhau.	Một người phụ nữ thừa cân với mái tóc đen dài, mặc áo sơ mi hồng có gắn thẻ tên đang thoa son môi.
A man fixing a little girl's bicycle.	Một người đàn ông sửa xe đạp của một cô gái nhỏ.	Một người đàn ông đang sửa xe đạp cho một bé gái.
Two girls in puffy skirts are dancing in front of some musicians in the street.	Hai cô gái mặc váy cao su đang nhảy múa trước mặt một số nhạc sĩ trên đường phố.	Hai cô gái mặc váy bồng đang nhảy trước mặt một số nhạc công trên phố.
The yellow dog is carrying a stick by water.	Con chó đang mang theo một cái que bằng nước.	Con chó vàng đang mang theo một cây gậy bên bờ nước.
A girl in a sweater is blocking the suns rays.	Một cô gái mặc áo len đang che nắng.	Một cô gái mặc áo len đang che nắng.
A rock concert is taking place.	Một buổi hòa nhạc đang diễn ra.	Một buổi hòa nhạc rock đang diễn ra.
Three women in bright colors and headdresses are holding love message cards.	Ba người phụ nữ có màu sắc rực rỡ và anh ta đang giữ những lá thư tình.	Ba người phụ nữ mặc trang phục sặc sỡ và đội mũ đội đầu đang cầm những tấm thiệp ghi thông điệp tình yêu.
A brown dog is digging in the dirt.	Một con chó màu nâu đang đào bới trong đất.	Một con chó nâu đang đào đất.
Young boy in a white striped shirt and headband holding a tennis racket.	Một cậu bé mặc áo sọc trắng và đội mũ trùm đầu cầm vợt.	Cậu bé mặc áo sơ mi sọc trắng và đội băng đô, đang cầm vợt tennis.
Two dogs running away from the camera in the woods.	Hai con chó đang chạy trốn khỏi máy quay trong rừng.	Hai con chó chạy trốn khỏi máy ảnh trong rừng.
A girl is playing in the fountain fully clothed.	Một cô gái đang chơi đùa trong dòng suối đầy sự mặc quần áo.	Một cô gái đang chơi đùa trong đài phun nước với quần áo đầy đủ.
Three young sumo wrestlers standing and listening to an announcer	Ba chú ba chú ba đang đứng và nghe một thông báo	Ba đô vật sumo trẻ tuổi đang đứng và lắng nghe người thông báo
Two male hikers inspect a log by the side of a forest path.	Hai người đàn ông đi bộ kiểm tra một bản ghi bên cạnh một con đường rừng.	Hai người đi bộ đường dài đang kiểm tra một khúc gỗ bên cạnh con đường mòn trong rừng.
Three players bring a team opponent to the ground.	Ba cầu thủ mang một đội đến mặt đất.	Ba người chơi vật một đội đối thủ xuống đất.
Two boys cross a city street while kicking a red soccer ball.	Có hai gã đang băng qua một đường phố trong khi đang đá banh.	Hai cậu bé băng qua đường trong thành phố trong khi đá một quả bóng đá màu đỏ.
A man holding up another with his back.	Một người đàn ông đứng sau lưng một người khác.	Một người đàn ông đang đỡ một người khác bằng lưng của mình.
White dog on mountainside turns to face something offstage, sky in background.	Con chó trắng trên sườn núi quay sang đối mặt với thứ gì đó ngoài sân khấu, trên bầu trời.	Chú chó trắng trên sườn núi quay mặt về phía thứ gì đó ngoài sân khấu, bầu trời ở phía sau.
A boy riding a skateboard on a skateboarding ramp	♪ Một cậu bé ôm một nụ cười ♪	Một cậu bé đang trượt ván trên đường dốc trượt ván
A long-haired, male musician is playing on a piano.	Một thời gian dài, nhạc công đàn ông đang chơi đàn piano.	Một nhạc công nam tóc dài đang chơi đàn piano.
Three athletes holding bouquets stand on the victory podium.	Ba vận động viên đang đứng trên chiến thắng.	Ba vận động viên cầm bó hoa đứng trên bục chiến thắng.
Two bald drag queens in red dresses	♪ ♪ ♪ ♪ ♪ ♪ ♪ ♪ ♪ ♪ ♪ ♪ ♪ ♪ ♪ ♪ ♪ ♪ ♪ ♪ ♪ ♪ ♪ ♪ ♪ ♪ ♪ ♪ ♪ ♪ ♪ ♪ ♪ ♪ ♪ ♪ ♪ ♪ ♪ ♪ ♪ ♪ ♪ ♪ ♪ ♪ ♪ ♪ ♪ ♪ ♪ ♪ ♪ ♪ ♪ ♪ ♪ ♪ ♪ ♪ ♪ ♪ ♪ ♪ ♪ ♪ ♪ ♪ ♪ ♪ ♪ ♪ ♪ ♪ ♪ ♪ ♪ ♪ ♪ ♪ ♪ ♪ ♪ ♪ ♪ ♪ ♪ ♪ ♪ ♪ ♪ ♪ ♪ ♪ ♪ ♪ ♪ ♪ ♪ ♪ ♪ ♪ ♪ ♪ ♪ ♪ ♪ ♪ ♪ ♪ ♪ ♪ ♪ ♪ ♪ ♪ ♪ ♪ ♪ ♪ ♪ ♪ ♪ ♪ ♪ ♪ ♪ ♪ ♪ ♪ ♪ ♪ ♪ ♪ ♪ ♪ ♪ ♪ ♪ ♪ ♪ ♪ ♪ ♪ ♪ ♪ ♪ ♪ ♪ ♪ ♪ ♪ ♪ ♪ ♪ ♪ ♪ ♪ ♪ ♪ ♪ ♪ ♪ ♪ ♪ ♪ ♪ ♪ ♪ ♪ ♪ ♪ ♪ ♪ ♪ ♪ ♪ ♪ ♪ ♪ ♪ ♪ ♪ ♪ ♪ ♪ ♪ ♪ ♪ ♪ ♪ ♪ ♪ ♪ ♪ ♪ ♪ ♪ ♪ ♪ ♪ ♪ ♪	Hai nữ hoàng drag hói đầu mặc váy đỏ
A young boy is hanging onto a clothing rack.	Một cậu bé đang mặc quần áo.	Một cậu bé đang treo mình trên giá treo quần áo.
A little girl wearing pink is holding on to a bar.	Một cô gái nhỏ mặc màu hồng đang bám lấy một quán bar.	Một cô bé mặc đồ màu hồng đang cầm một thanh xà.
A man in green jumps serveral motorbikes on his own motorbike.	Một người đàn ông có khả năng nhảy dù xanh tự lập.	Một người đàn ông mặc đồ xanh nhảy qua nhiều xe máy bằng chính chiếc xe máy của mình.
A woman playing with two young boys at a park	♪ Một người phụ nữ đang chơi đùa với hai thiếu nữ ở một công viên ♪	Một người phụ nữ đang chơi với hai cậu bé trong công viên
Four people are playing soccer on a beach.	Bốn người đang chơi đá banh trên bãi biển.	Bốn người đang chơi bóng đá trên bãi biển.
Two teenage girls hugging, one wearing a bicycle helmet, with cyclists in the background.	Hai em gái tuổi thiếu niên đang búi, một em đội mũ bảo hiểm đạp xe, với những người đạp xe ở phía sau.	Hai cô gái tuổi teen đang ôm nhau, một người đội mũ bảo hiểm xe đạp, với những người đi xe đạp ở phía sau.
Two medium sized dogs run across the snow.	Hai con chó to lớn chạy ngang qua tuyết.	Hai chú chó cỡ trung chạy băng qua tuyết.
A woman is standing in a green field holding a white dog and pointing at a brown dog.	Một người phụ nữ đứng trên một cánh đồng xanh với một con chó trắng và chỉ vào một con chó nâu.	Một người phụ nữ đang đứng trên cánh đồng xanh, bế một chú chó trắng và chỉ vào một chú chó nâu.
A table full of pictures in frames, at an outdoor market.	Một cái bàn đầy hình ảnh trong khung, tại một chợ ngoài trời.	Một chiếc bàn đầy ảnh đóng khung tại một khu chợ ngoài trời.
Two people sit at a table outside against a wall and make faces.	Hai người ngồi vào một bàn tiệc, đối diện nhau và xây mặt lên.	Hai người ngồi ở một chiếc bàn bên ngoài, dựa vào tường và làm mặt xấu.
Two guys with nipple piercings are smiling.	Hai người có điểm yếu đang cười.	Hai chàng trai đeo khuyên ở núm vú đang mỉm cười.
A child is laying on a beige rug laughing.	Một đứa bé đang nằm trên một nụ cười ngọt ngào.	Một đứa trẻ đang nằm cười trên tấm thảm màu be.
A man and woman are locked arms sitting down and all dressed up.	Một người đàn ông và đàn bà bị khóa vũ khí ngồi xuống và ăn mặc chỉnh tề.	Một người đàn ông và một người phụ nữ đang ngồi khoanh tay và ăn mặc chỉnh tề.
Two woman are mud wrestling in a kiddie pool.	Hai người phụ nữ đang đấu vật trong một cuộc thi sinh con.	Hai người phụ nữ đang vật lộn với bùn trong hồ bơi trẻ em.
A guy in a white shirt is walking with a drink in his hand.	Một gã mặc áo sơ mi trắng đang đi bộ với một ly rượu trong tay.	Một chàng trai mặc áo sơ mi trắng đang đi bộ với một ly đồ uống trên tay.
Two people are silhouetted against a lake reflecting a painted sky.	Hai người được đánh giá ngược lại với một bức tranh sơn.	Hai người hiện lên dưới bóng của một hồ nước phản chiếu bầu trời được vẽ.
Several people sit at a table in formal clothing.	Nhiều người ngồi vào bàn trong quần áo.	Một số người mặc trang phục trang trọng ngồi ở bàn.
Two girls (one dressed in blue, and one dressed in pink) are racing one another on rollerskates.	Hai em gái (một em mặc áo xanh, và một em mặc màu hồng) đang đua xe với nhau.	Hai cô gái (một mặc đồ xanh và một mặc đồ hồng) đang đua nhau trên giày trượt patin.
The four people sit on a pile of rocks.	Bốn người ngồi trên một đống đá.	Bốn người ngồi trên một đống đá.
A group of people do tricks on motorbikes.	Một nhóm người làm trò lừa đảo.	Một nhóm người đang biểu diễn nhào lộn trên xe máy.
Bicyclist in racing gear rides through forest area.	Đội tuần tra đua xe ngựa đi qua khu rừng.	Người đi xe đạp mặc đồ đua đi qua khu rừng.
A man in a green shirt is walking on the beach carrying his sneakers.	Một người đàn ông mặc áo xanh đang đi trên bờ biển với cái áo của anh ta.	Một người đàn ông mặc áo sơ mi xanh đang đi trên bãi biển và mang theo đôi giày thể thao.
Several men standing around an antique race car	♪ Những người đàn ông đứng xung quanh một xe đua ♪	Một số người đàn ông đứng xung quanh một chiếc xe đua cổ
Two men work under the hood of a white race car.	Hai người đàn ông làm việc dưới sự trùm đầu của một xe đua da trắng.	Hai người đàn ông làm việc dưới mui xe đua màu trắng.
Children jump off the edge into a pool.	Trẻ em nhảy khỏi bờ thành một hồ bơi.	Trẻ em nhảy từ mép hồ xuống hồ bơi.
A man on the edge of a wall about to fall off.	Một người đàn ông trên rìa tường sắp rơi ra.	Một người đàn ông đứng trên mép tường sắp ngã xuống.
A woman in a striped outfit on a bike.	Một người phụ nữ mặc đồ sọc trên một chiếc xe đạp.	Một người phụ nữ mặc trang phục kẻ sọc đang đạp xe.
A girl dressed in black is posing for the camera.	Một cô gái mặc đồ đen là viết tắt cho máy chụp hình.	Một cô gái mặc đồ đen đang tạo dáng trước ống kính máy ảnh.
Man in shorts standing by the water.	Người mặc đồ ngắn đang đứng cạnh mặt nước.	Người đàn ông mặc quần short đứng bên bờ nước.
Four black men are sitting on the steps of a church.	Bốn người đàn ông da đen đang ngồi trên bậc thang của một nhà thờ.	Bốn người đàn ông da đen đang ngồi trên bậc thềm của một nhà thờ.
A crane operates amidst piles of rubble.	Một đống bột nhào.	Một chiếc cần cẩu đang hoạt động giữa đống đổ nát.
A gymnast wearing red and white is mid-twirl on an uneven bar.	Một người mặc đồ đỏ và trắng là trung kích trên một quán bar.	Một vận động viên thể dục dụng cụ mặc đồ đỏ và trắng đang xoay tròn trên thanh xà lệch.
An older lady in a green sweater picks out vegetables.	Một người phụ nữ lớn tuổi mặc áo len xanh chọn rau.	Một phụ nữ lớn tuổi mặc áo len xanh đang chọn rau.
Two men are crafting items in a workshop with tools.	Hai người đàn ông đang tập hợp các công cụ trong một công ty với công cụ.	Hai người đàn ông đang chế tạo đồ vật trong một xưởng bằng các công cụ.
A teacher in white and a little girl wearing a yellow dress playing with building block.	Một giáo viên mặc đồ trắng và một cô bé mặc váy màu vàng đang chơi với tòa nhà.	Một giáo viên mặc đồ trắng và một bé gái mặc váy vàng đang chơi xếp hình.
A young child sleeping in her bed with an open book on her chest.	Một đứa bé đang nằm trên giường với một cuốn sách mở trên ngực.	Một đứa trẻ đang ngủ trên giường với một cuốn sách mở trên ngực.
A woman eating in the grass on a beautiful day.	Một người phụ nữ ăn cỏ trong một ngày đẹp trời.	Một người phụ nữ đang ăn trên bãi cỏ vào một ngày đẹp trời.
A man walks down a cobblestone street next to buildings painted tan with red eaves.	Một người đàn ông đi dọc theo một con đường đá lát đá cạnh những tòa nhà sơn màu nâu với những mái hiên màu đỏ.	Một người đàn ông đi dọc theo con phố lát đá cuội bên cạnh những tòa nhà được sơn màu nâu rám nắng với mái hiên màu đỏ.
A woman wearing a hat with making bread.	Một người phụ nữ đội một cái nón với việc làm bánh mì.	Một người phụ nữ đội mũ đang làm bánh mì.
A solitary woman uses a large primitive mortar and pestle to crush plant material as she stands in a stubble field.	Một người đàn bà đơn độc sử dụng một loại nấm thô sơ và có khả năng nghiền cây khi đứng trên một cánh đồng cỏ khô cằn.	Một người phụ nữ đơn độc đang sử dụng một chiếc cối và chày thô sơ lớn để nghiền nát nguyên liệu thực vật khi cô ấy đứng trên một cánh đồng rạ.
A man in a karate is performing in front of two judges.	Một người đàn ông đang biểu diễn trước mặt hai quan tòa.	Một người đàn ông tập karate đang biểu diễn trước hai giám khảo.
A man in formal attire plays a piano on the sidewalk of a city street.	Một người đàn ông có phong tục chơi đàn dương cầm trên vỉa hè của một thành phố.	Một người đàn ông mặc trang phục trang trọng đang chơi đàn piano trên vỉa hè của một con phố trong thành phố.
An elderly man sitting in a chair, eating some snacks.	Một người đàn ông lớn tuổi ngồi trên ghế, ăn vài món ăn nhẹ.	Một người đàn ông lớn tuổi đang ngồi trên ghế và ăn đồ ăn nhẹ.
A woman in a white shirt works behind the counter at a cafe.	Một người phụ nữ mặc áo sơ mi trắng làm việc phía sau quầy ở quán cà phê.	Một người phụ nữ mặc áo sơ mi trắng đang làm việc sau quầy tại một quán cà phê.
A man with work clothes on standing on the back of a truck.	Một người đàn ông mặc quần áo công việc đứng sau xe tải.	Một người đàn ông mặc quần áo lao động đang đứng trên thùng xe tải.
Two children looking at horses through a small fence.	Hai đứa trẻ nhìn qua một hàng rào nhỏ.	Hai đứa trẻ đang ngắm ngựa qua hàng rào nhỏ.
A window with some type of design painted on it.	Một cửa sổ với một loại thiết kế sơn trên nó.	Một cửa sổ có một số loại họa tiết được sơn trên đó.
A woman wearing a bright pink overcoat makes a face to a woman wearing a purple overcoat while standing outside a Vitamin Shoppe.	Một phụ nữ mặc áo khoác màu hồng màu hồng làm cho một khuôn mặt đối với một phụ nữ mặc một áo choàng màu tím mặc áo khoác trong khi đứng bên ngoài cửa hàng.	Một người phụ nữ mặc áo khoác màu hồng tươi làm mặt xấu với một người phụ nữ mặc áo khoác màu tím khi đứng bên ngoài một cửa hàng Vitamin.
A cowboy wrapping up his arm with a bandage.	Một chàng cao bồi trên cánh tay của mình với một băng bó.	Một chàng cao bồi đang băng bó cánh tay của mình.
A man in a yellow shirt and a man in a dark blue shirt talking.	Một người đàn ông mặc áo sơ mi vàng và một người đàn ông mặc áo sơ mi màu xanh đen đang nói chuyện.	Một người đàn ông mặc áo sơ mi vàng và một người đàn ông mặc áo sơ mi xanh đậm đang nói chuyện.
Three Asian children sitting on a couch with tapestries hanging in the background.	Ba đứa trẻ Châu Á ngồi trên ghế dài với những tấm thảm thêu treo trên nền nhà.	Ba đứa trẻ châu Á đang ngồi trên ghế dài với những tấm thảm treo ở phía sau.
A girl in a red shirt jumps up to hit a tennis ball.	Một cô gái mặc áo đỏ nhảy lên để chơi bóng vợt.	Một cô gái mặc áo sơ mi đỏ nhảy lên đánh một quả bóng tennis.
A man posing the camera with green crane.	Một người đeo ống kính có màu xanh lá cây.	Một người đàn ông đang tạo dáng chụp ảnh với con sếu xanh.
A man clinks bottles with another person while smiling in a restaurant.	Một người đàn ông nhấp nháy với một người khác khi đang mỉm cười trong một nhà hàng.	Một người đàn ông cụng chai với một người khác trong khi mỉm cười trong một nhà hàng.
A man is loading a box truck with lots of baked pretzels.	Một người đàn ông đang chất đầy một hộp hộp với rất nhiều bánh nướng.	Một người đàn ông đang chất một xe tải thùng đầy bánh quy nướng.
A man in a black jacket plays the guitar out in public.	Một người đàn ông mặc áo khoác đen chơi đàn xếp hình ở nơi công cộng.	Một người đàn ông mặc áo khoác đen đang chơi đàn ghi-ta ở nơi công cộng.
A dance group performs in a parade in china.	Một nhóm nhảy trong một buổi diễu hành.	Một nhóm nhảy biểu diễn trong một cuộc diễu hành ở Trung Quốc.
A man stands on a rocky cliff overlooking a body of water.	Một người đàn ông đứng trên vách đá trên một vũng nước.	Một người đàn ông đứng trên vách đá nhìn xuống một vùng nước.
Police officer watching woman exit from bus.	Cảnh sát cảnh sát theo dõi phụ nữ thoát khỏi xe buýt.	Cảnh sát đang theo dõi người phụ nữ bước ra khỏi xe buýt.
Two middle-aged police officers watch over a parking lot, at night.	2 cảnh sát cảnh sát canh gác ở bãi đậu xe, vào ban đêm.	Hai cảnh sát trung niên đang canh gác bãi đậu xe vào ban đêm.
Two men in blue shirts looking at a soccer game.	Hai người đàn ông mặc áo sơ mi màu xanh đang nhìn vào một trận bóng đá.	Hai người đàn ông mặc áo sơ mi xanh đang xem một trận bóng đá.
A group of men in blue uniforms are standing together.	Một nhóm người mặc đồng phục màu xanh đang đứng cùng nhau.	Một nhóm đàn ông mặc đồng phục màu xanh đang đứng cùng nhau.
A young lady doing yoga on the beach.	Một cô gái trẻ đang tập thể dục trên bãi biển.	Một cô gái trẻ đang tập yoga trên bãi biển.
A large crowd of people are standing around in a park and a few are playing instruments.	Một đám đông người đứng quanh công viên và vài người đang chơi nhạc cụ.	Một đám đông đang đứng xung quanh trong công viên và một số người đang chơi nhạc cụ.
A man with a balloon hat makes balloon animals.	Một người đàn ông với một cái mũ bảo hiểm làm nên những con thú.	Một người đàn ông đội mũ bóng bay đang làm những con vật bằng bóng bay.
A man grilling meat on an outdoor grilling pit.	Một con lợn nướng thịt trên một con chuột ngoài trời.	Một người đàn ông đang nướng thịt trên hố nướng ngoài trời.
Two men selling fruit at a fruit market.	Hai người bán hoa quả ở chợ.	Hai người đàn ông đang bán trái cây ở một chợ trái cây.
Brunette woman in a white bikini pouring a drink into a man's cup.	Một người đàn bà tóc bạc trong một cái bánh mì trắng rót rượu vào ly rượu của một người đàn ông.	Người phụ nữ tóc nâu mặc bikini trắng đang rót đồ uống vào cốc của một người đàn ông.
Boy in sunglasses is running behind a fair.	Chữ số là đang chạy đằng sau một hội chợ.	Cậu bé đeo kính râm đang chạy phía sau một hội chợ.
A gloved hand holds what appears to be an oversize nail against a log.	Một bàn tay chai cứng nắm giữ một cái gì đó có vẻ như là một quá mức đinh chống lại một khúc gỗ.	Một bàn tay đeo găng tay đang giữ một vật trông giống như một chiếc đinh quá khổ trên một khúc gỗ.
A man in a plaid shirt shows off a black set of gloves.	Một người đàn ông mặc áo sọc hiển thị một bộ màu đen của găng tay.	Một người đàn ông mặc áo sơ mi kẻ sọc khoe đôi găng tay màu đen.
Two men in white plastic chairs sitting in a doorway.	Hai người đàn ông mặc đồ nhựa trắng ngồi trong ô cửa.	Hai người đàn ông ngồi trên ghế nhựa màu trắng ở cửa ra vào.
A young girl in a red dress is wearing a black cowboy hat.	Một cô gái trẻ mặc váy đỏ đội mũ cao bồi đen.	Một cô gái trẻ mặc váy đỏ và đội mũ cao bồi màu đen.
Man in red and white soccer uniform stands on the field boundary lines with yellow and blue soccer ball.	Người đàn ông mặc đồng phục bóng trắng màu đỏ và trắng đứng trên sân dọc với bóng đá màu vàng và màu xanh.	Người đàn ông mặc đồng phục bóng đá màu đỏ và trắng đứng trên đường biên sân với quả bóng đá màu vàng và xanh.
People jump over a mountain crevasse on a rope.	Người ta nhảy qua một khe núi trên một sợi dây thừng.	Mọi người nhảy qua khe núi bằng dây thừng.
People look on as participants in a marathon pass by.	Mọi người nhìn vào như những người tham gia trong một vượt qua.	Mọi người dõi theo những người tham gia cuộc chạy marathon đi qua.
People on laptops in front pf a large window.	Người dân trên laptop trước mặt một cửa sổ lớn.	Mọi người đang dùng máy tính xách tay ở phía trước một cửa sổ lớn.
A disc jockey busy at work as lights shine upon him.	Một người bận rộn làm việc như ánh sáng chiếu vào anh ta.	Một DJ đang bận rộn làm việc dưới ánh đèn chiếu vào anh.
A man wearing gloves carries corn through a field.	Một người đàn ông đeo găng tay đi xuyên qua cánh đồng.	Một người đàn ông đeo găng tay đang mang ngô qua cánh đồng.
A photo is taken of a mirror reflection of a cafe.	Một bức ảnh được chụp từ một tấm gương phản chiếu của một bức tranh.	Một bức ảnh chụp hình ảnh phản chiếu của một quán cà phê.
A muslim woman holding balloons at an islamic event	Một cô gái cuồng cuồng nữ đang cầm bóng trong một cuộc thi đấu là chủ nghĩa tình dục	Một phụ nữ Hồi giáo cầm bóng bay tại một sự kiện Hồi giáo
A woman sits in a caged in area with a cat and two bunnies.	Một người phụ nữ ngồi trong một lồng trong khu vực với một con mèo và hai.	Một người phụ nữ ngồi trong khu vực bị nhốt cùng một con mèo và hai con thỏ.
A woman sitting against a brick wall inside a building.	Một người phụ nữ ngồi dựa vào một bức tường gạch trong một tòa nhà.	Một người phụ nữ đang ngồi dựa vào bức tường gạch bên trong một tòa nhà.
Three young women face each other while sitting on red plush chairs.	3 phụ nữ trẻ đối mặt với nhau trong khi ngồi trên đỏ cộng với phụ nữ.	Ba cô gái trẻ ngồi đối diện nhau trên những chiếc ghế nhung đỏ.
A woman in a blue shirt walking in a village.	Một người phụ nữ mặc áo sơ mi màu xanh bước đi trong một ngôi làng.	Một người phụ nữ mặc áo sơ mi xanh đang đi bộ trong làng.
Six children, sitting on a step with notepads and crayons.	Sáu đứa trẻ, ngồi trên một bước với ghi chú và trang bìa.	Sáu đứa trẻ đang ngồi trên bậc thang với những cuốn sổ tay và bút màu.
A tan dog playing with a stick on the shore.	Một con chó đang chơi đùa với một cái que trên bờ biển.	Một chú chó rám nắng đang chơi đùa với một cây gậy trên bờ biển.
Two dogs playfully bite a third dog, which has its tongue sticking out.	Hai con chó cái cắn một con chó thứ ba, mà lưỡi nó có phát ra.	Hai con chó đùa giỡn cắn con chó thứ ba, con chó này đang thè lưỡi ra.
A child is on a motorcycle smiling.	Một đứa bé đang ôm một con gấu.	Một đứa trẻ đang mỉm cười trên xe máy.
6 people are gathered around to eat a big dinner.	6 người tụ tập xung quanh để ăn một bữa tiệc lớn.	6 người tụ tập lại để ăn một bữa tối thịnh soạn.
Santa Claus being photographed at a holiday media event.	Ông già nội ngoại đã từng được thừa nhận vào một buổi biểu diễn.	Ông già Noel được chụp ảnh tại một sự kiện truyền thông ngày lễ.
Military Families are marching through New York on a rainy day.	Quân đội đang tiến quân qua New York trong một ngày.	Các gia đình quân nhân đang diễu hành qua New York vào một ngày mưa.
A woman in a blue helmet and red pants riding a motorcycle.	Một người phụ nữ đội mũ xanh và quần đỏ đeo một chiếc xe máy.	Một người phụ nữ đội mũ bảo hiểm màu xanh và quần đỏ đang lái xe máy.
Several men are wearing martial arts uniforms while they perform some moves in unison.	Nhiều người đàn ông đang mặc quân phục võ thuật trong khi họ thực hiện một số bước trong hiệp đấu.	Một số người đàn ông mặc đồng phục võ thuật trong khi thực hiện một số động tác cùng lúc.
A young lady and man dressed in warriors costume wielding sticks with a group of people in the background.	Một cô gái trẻ và một người đàn ông mặc trang phục chiến binh với một nhóm người ở phía sau.	Một cô gái trẻ và một người đàn ông mặc trang phục chiến binh đang cầm gậy với một nhóm người ở phía sau.
A man in a uniform walking on a street with two cars and a tree.	Một người đàn ông mặc đồng phục đi bộ trên một con đường với hai xe và một cây.	Một người đàn ông mặc đồng phục đang đi trên con phố có hai chiếc ô tô và một cái cây.
Young woman climbing rock face	♪ ♪ ♪ ♪ ♪ ♪ ♪ ♪ ♪ ♪ ♪ ♪ ♪ ♪ ♪ ♪ ♪ ♪ ♪ ♪ ♪ ♪ ♪ ♪ ♪ ♪ ♪ ♪ ♪ ♪ ♪ ♪ ♪ ♪ ♪ ♪ ♪ ♪ ♪ ♪ ♪ ♪ ♪ ♪ ♪ ♪ ♪ ♪ ♪ ♪ ♪ ♪ ♪ ♪ ♪ ♪ ♪ ♪ ♪ ♪ ♪ ♪ ♪ ♪ ♪ ♪ ♪ ♪ ♪ ♪ ♪ ♪ ♪ ♪ ♪ ♪ ♪ ♪ ♪ ♪ ♪ ♪ ♪ ♪ ♪ ♪ ♪ ♪ ♪ ♪ ♪ ♪ ♪ ♪ ♪ ♪ ♪ ♪ ♪ ♪ ♪ ♪ ♪ ♪ ♪ ♪ ♪ ♪ ♪ ♪ ♪ ♪ ♪ ♪ ♪ ♪ ♪ ♪ ♪ ♪ ♪ ♪ ♪ ♪ ♪ ♪ ♪ ♪ ♪ ♪ ♪ ♪ ♪ ♪ ♪ ♪ ♪ ♪ ♪ ♪ ♪ ♪ ♪ ♪ ♪ ♪ ♪ ♪ ♪ ♪ ♪ ♪ ♪ ♪ ♪ ♪ ♪ ♪ ♪	Người phụ nữ trẻ đang leo lên vách đá
An elderly man in a light blue coat works on a car on the roadside.	Một người đàn ông cao tuổi mặc áo khoác màu xanh sáng làm việc trên một chiếc xe hơi trên đường đi.	Một ông già mặc áo khoác xanh nhạt đang sửa xe ô tô bên lề đường.
People looking over several colored pieces of paper spread on a table.	Người ta tìm kiếm trên những mảnh giấy rải trên một cái bàn.	Mọi người đang nhìn vào những tờ giấy màu trải trên bàn.
A man sings and plays the guitar into a microphone.	Một người đàn ông đàn ông hát và chơi guitar vào một âm thanh.	Một người đàn ông vừa hát vừa chơi đàn ghi-ta vào micro.
Two men sitting in a restaurant.	Hai người đàn ông ngồi trong một nhà hàng.	Hai người đàn ông đang ngồi trong nhà hàng.
Two women in shorts run down a beach along the water.	Hai phụ nữ mặc quần đùi chạy trên một bãi biển dọc theo mặt nước.	Hai người phụ nữ mặc quần short chạy dọc theo bãi biển, dọc theo mặt nước.
Construction workers having a discussion by the tracks.	Những công nhân đang có một cuộc thảo luận theo đường ray.	Công nhân xây dựng đang thảo luận bên đường ray.
A view of a pedestrian thoroughfare, featuring a man in a black apron and a white baseball cap standing in the middle of the image.	Một cái nhìn của một người vô cùng nghiêm túc, với một người đàn ông mặc áo trắng đen và một mũ bóng chày trắng đứng ở giữa bức ảnh.	Một góc nhìn về một con đường dành cho người đi bộ, có một người đàn ông mặc tạp dề đen và đội mũ bóng chày màu trắng đứng ở giữa hình ảnh.
A group of people are playing on an object.	Một nhóm người đang chơi trên một đối tượng.	Một nhóm người đang chơi đùa với một đồ vật.
A little girl in a blue outfit is climbing on metal railings in the street.	Một cô bé mặc đồ xanh đang chạy trên đường sắt.	Một bé gái mặc bộ đồ màu xanh đang trèo lên lan can kim loại trên phố.
A group of men sitting and talking behind some green fruit.	Một nhóm đàn ông ngồi và nói chuyện đằng sau một số màu xanh lá cây.	Một nhóm đàn ông đang ngồi nói chuyện sau những trái cây xanh.
A guy with a yellow outfit on standing behind a microphone under a tent.	Một người đàn ông với bộ đồ màu vàng đang đứng sau tấm vải mỏng dưới một cái lều.	Một anh chàng mặc trang phục màu vàng đứng sau micro dưới một cái lều.
A brown dog with a purple Frisbee in its mouth.	Một con chó màu nâu với một cái túi màu tím trong miệng.	Một chú chó nâu đang ngậm một chiếc đĩa Frisbee màu tím trong miệng.
It looks like a man practicing his martial arts moves near some muddy looking water.	Nó trông giống như một người đàn ông luyện tập võ thuật của mình đang di chuyển gần một cái gì đó nhìn vào nước.	Trông giống như một người đàn ông đang luyện tập các động tác võ thuật của mình gần một vùng nước đục ngầu.
A woman with a drink and a woman with a cellphone.	Một người phụ nữ với một ly rượu và một người phụ nữ với một cái điện thoại.	Một người phụ nữ cầm đồ uống và một người phụ nữ cầm điện thoại di động.
A child in a red coat waves a hand in the air while lying in snow beside a red plastic sled.	Một đứa trẻ mặc áo khoác đỏ vẫy tay trên không trong khi nằm trong tuyết bên cạnh một tấm nhựa màu đỏ.	Một đứa trẻ mặc áo khoác đỏ đang vẫy tay trong không khí khi nằm trên tuyết bên cạnh chiếc xe trượt tuyết bằng nhựa màu đỏ.
A woman sitting next to her purse watching dogs at the park.	Một người phụ nữ ngồi kế bên ví của cô xem chó ở công viên.	Một người phụ nữ ngồi cạnh ví và ngắm những chú chó ở công viên.
Three men are standing on a stage, one is wearing clown makeup and holding a guitar.	Ba người đàn ông đang đứng trên sân khấu, một người đang trang điểm và ôm một cây guitar.	Ba người đàn ông đang đứng trên sân khấu, một người trang điểm như chú hề và cầm đàn ghi-ta.
A woman is processing plant fluid in a tribal village	♪ Một người phụ nữ là một người phụ nữ ♪	Một người phụ nữ đang xử lý chất lỏng thực vật ở một ngôi làng bộ lạc
The woman in the red dress is dancing with the man in a suit.	Người phụ nữ mặc đầm đỏ đang nhảy múa với người đàn ông mặc đồ vest.	Người phụ nữ mặc váy đỏ đang khiêu vũ với người đàn ông mặc vest.
Two small dogs follow a larger dog with a tennis ball	Hai con chó nhỏ theo một con chó nhỏ với một trái banh	Hai chú chó nhỏ đuổi theo một chú chó lớn hơn với một quả bóng tennis
A man with a bushy beard and a baseball cap sits on a park bench.	Một người đàn ông với một bộ râu dài và một cái nón bóng chày ngồi trên một cái ghế công viên.	Một người đàn ông có bộ râu rậm và đội mũ bóng chày đang ngồi trên băng ghế công viên.
An African tribe is standing in their garden with the forest in the background.	Một chi phái Phi Châu đang đứng trong vườn với khu rừng phía sau.	Một bộ tộc châu Phi đang đứng trong khu vườn của họ, phía sau là khu rừng.
A young girl is trying to brush a goat.	Một cô gái trẻ đang cố gắng vẽ một con dê.	Một cô gái trẻ đang cố chải lông cho một con dê.
Asian people sitting at a restaurant with yellow chairs.	Những người dân thường ngồi tại một nhà hàng với ghế có ghế.	Người Châu Á đang ngồi trong một nhà hàng với những chiếc ghế màu vàng.
A baby girl eats a cookie while seated in a highchair and wearing a bib.	Một bé gái đang ăn bánh trong khi ngồi trên ghế cao và mặc áo choàng.	Một bé gái đang ăn bánh quy khi ngồi trên ghế cao và đeo yếm.
A gray-haired man wearing black gloves is moving the lawn.	Một người đàn ông da đen đeo găng tay đen đang di chuyển bãi cỏ.	Một người đàn ông tóc hoa râm đeo găng tay đen đang cắt cỏ.
A woman reads a book while sitting in a row of red chairs.	Một người đàn bà đọc một cuốn sách trong khi ngồi trong hàng ghế đỏ.	Một người phụ nữ đang đọc sách trong khi ngồi trên một hàng ghế màu đỏ.
A child claps while riding on a woman's shoulders.	Một đứa trẻ khóc khi cưỡi trên vai một người phụ nữ.	Một đứa trẻ vỗ tay khi ngồi trên vai một người phụ nữ.
A family is walking on the sidewalk through the snow while a man sits on the side with his paper cup.	Một gia đình đang đi bộ trên vỉa hè băng qua tuyết trong khi một người đàn ông ngồi bên cạnh với tờ giấy của mình.	Một gia đình đang đi bộ trên vỉa hè trong tuyết trong khi một người đàn ông ngồi ở bên cạnh với chiếc cốc giấy của mình.
A cat sits on top of a store sign.	Một con mèo ngồi trên một cửa hàng.	Một con mèo ngồi trên đỉnh biển hiệu của một cửa hàng.
A man in a pink shirt and black jacket with headphones on.	Một người đàn ông mặc áo sơ mi màu hồng và mặc áo khoác đen mặc quần bó.	Một người đàn ông mặc áo sơ mi hồng và áo khoác đen, đeo tai nghe.
A young man about to throw a football.	Một chàng trai trẻ chuẩn bị chơi bóng bầu dục.	Một chàng trai trẻ chuẩn bị ném bóng bầu dục.
A guy and a girl going down a spiral walkway.	Một người đàn ông và một cô gái đi xuống một con đường mòn.	Một chàng trai và một cô gái đang đi xuống lối đi xoắn ốc.
A woman with pink hair bent down on the sidewalk holding to pink dogs.	Một người phụ nữ với mái tóc hồng cúi xuống trên mặt băng dính với những con chó.	Một người phụ nữ tóc hồng đang cúi xuống vỉa hè, bế những chú chó màu hồng.
A male in a suit holding a beverage in a cup walking down the sidewalk, next to a city bus.	Một người đàn ông mặc vest cầm một thức uống trong ly đi dọc theo vỉa hè, bên cạnh một chiếc xe buýt thành phố.	Một người đàn ông mặc vest đang cầm đồ uống trong cốc đi dọc vỉa hè, bên cạnh một chiếc xe buýt thành phố.
Man jumping with a rock formation in background.	Người đàn ông nhảy với một tảng đá tạo thành nền.	Người đàn ông đang nhảy với khối đá ở phía sau.
A person in a red jacket with black pants holding rainbow ribbons.	Một người mặc áo khoác màu đỏ với quần đen đang đeo đèn chùm cầu vồng.	Một người mặc áo khoác đỏ với quần đen, tay cầm những dải ruy băng cầu vồng.
A woman puts her arm on a person sitting in a wheelchair.	Một phụ nữ đặt tay lên người đang ngồi trên xe lăn.	Một người phụ nữ đặt tay lên người đang ngồi trên xe lăn.
A man in a white apron is cooking something with eggs on a pan outside for a woman in a tan jacket.	Một người đàn ông mặc đồ lót trắng đang nấu món gì đó với trứng trên chảo bên ngoài cho một người phụ nữ mặc áo khoác rám nắng.	Một người đàn ông mặc tạp dề trắng đang nấu món gì đó với trứng trên chảo ở bên ngoài cho một người phụ nữ mặc áo khoác màu nâu.
A woman with a push-to-talk cellphone and headset waiting at a crosswalk.	Một người phụ nữ với một tiếng nói trước và tai tai nghe chờ đợi tại một lối đi qua.	Một người phụ nữ đeo điện thoại di động có chức năng bấm để nói và tai nghe đang chờ ở vạch qua đường.
A group of men walk down a city street.	Một nhóm người đàn ông đi xuống một khu phố.	Một nhóm đàn ông đang đi bộ trên phố.
A road next to an interesting place with lots of pillars.	Một con đường bên cạnh một nơi thú vị với rất nhiều các tế bào.	Một con đường bên cạnh một địa điểm thú vị có nhiều cột trụ.
A group of people in black standing on a dock nearby a long structure.	Một nhóm người da đen đứng ở một cảng gần một tòa nhà dài.	Một nhóm người mặc đồ đen đứng trên bến tàu gần một công trình dài.
Man carrying a few cases of beer.	Mang theo vài thùng bia.	Người đàn ông đang mang theo một vài thùng bia.
A middle-aged man is sitting down and playing the accordion.	Một người đàn ông trung niên đang ngồi xuống và chơi trò thắt lưng.	Một người đàn ông trung niên đang ngồi chơi đàn accordion.
Girl with green arm band, hair ties, and earrings stands outside.	Cô gái với dây đeo tay màu xanh lá, dây buộc tóc, và đeo tai đứng ở ngoài.	Cô gái đeo băng tay màu xanh lá cây, buộc tóc và đeo khuyên tai đứng bên ngoài.
A young girl in a pink shirt is on a beach running toward the ocean.	Một cô gái trẻ mặc áo sơ mi màu hồng đang chạy ra biển.	Một cô gái trẻ mặc áo sơ mi hồng đang chạy trên bãi biển về phía đại dương.
A skateboarder in a black t-shirt and jeans skating threw the city.	Một kẻ mặc áo đen mặc áo thun đen và mặc quần lót, ném vào thành phố.	Một vận động viên trượt ván mặc áo phông đen và quần jean đang trượt ván khắp thành phố.
A man in a jacket is taking a photograph of a large building.	Một người mặc áo khoác đang chụp ảnh một tòa nhà lớn.	Một người đàn ông mặc áo khoác đang chụp ảnh một tòa nhà lớn.
People on the sideline of a soccer match.	Những người chơi bóng đá.	Những người ở bên lề một trận đấu bóng đá.
In this photo there is a family of four dashing across a busy street in the city.	Trong bức ảnh này có một gia đình 4 người đi ngang qua một con đường bận rộn trong thành phố.	Trong bức ảnh này có một gia đình bốn người đang vội vã băng qua một con phố đông đúc trong thành phố.
A group of people walk down the street in the sun.	Một nhóm người đi bộ trên phố dưới ánh mặt trời.	Một nhóm người đang đi bộ trên phố dưới ánh nắng mặt trời.
A street near a stoplight with several people including a man wearing a brown coat and sunglasses with his hand to his face.	Một con đường gần một điểm dừng với một số người bao gồm một người đàn ông mặc áo khoác màu nâu và đeo kính với bàn tay của mình vào mặt của mình.	Một con phố gần đèn giao thông có một số người, trong đó có một người đàn ông mặc áo khoác nâu, đeo kính râm và đưa tay lên mặt.
Some plants are growing near the window.	Một số cây mọc gần cửa sổ.	Một số cây đang mọc gần cửa sổ.
This player with the blue helmet was at bat and just finished swinging at the ball during a team baseball game.	Cái này với cái mũ màu xanh đang đập bóng và vừa mới đánh xong quả bóng trong trận bóng chày của đội bóng chày.	Cầu thủ đội mũ bảo hiểm màu xanh này đang đánh bóng và vừa mới vung bóng trong một trận bóng chày đồng đội.
The woman in the gold coat hurries to catch the subway.	Người phụ nữ trong chiếc áo khoác vàng để đi tàu điện ngầm.	Người phụ nữ mặc áo khoác vàng vội vã đi tàu điện ngầm.
Some people sit on benches under rows of trees in front of a building.	Một số người ngồi trên những hàng cây trước một tòa nhà.	Một số người ngồi trên băng ghế dưới hàng cây trước tòa nhà.
A man in a suit is sitting at a bus stop.	Một người đàn ông trong bộ đồ đang ngồi ở trạm xe buýt.	Một người đàn ông mặc vest đang ngồi ở trạm xe buýt.
An African American man surrounded by empty overturned white buckets and dark colored crates expresses himself through a message handwritten on cardboard.	Một người đàn ông người Mỹ da trắng da trắng da trắng bao quanh và những thùng màu đen hiện mình thông qua một thông điệp trên trán.	Một người đàn ông Mỹ gốc Phi được bao quanh bởi những chiếc xô trắng úp ngược và những chiếc thùng màu tối thể hiện bản thân thông qua một thông điệp viết tay trên bìa cứng.
A young brunette woman eating and drinking something.	Một cô gái trẻ tuổi đang ăn uống gì đó.	Một phụ nữ trẻ tóc nâu đang ăn và uống thứ gì đó.
A man in a suit and hat is playing the guitar on the street.	Một người đàn ông mặc vest và đội mũ đang chơi guitar trên đường phố.	Một người đàn ông mặc vest và đội mũ đang chơi đàn ghi-ta trên phố.
A woman in a red vest working at a computer.	Một người phụ nữ mặc đồ màu đỏ đang làm việc với máy tính.	Một người phụ nữ mặc áo vest đỏ đang làm việc trên máy tính.
People standing around incense, wafting the smoke into their faces.	Dân_sự đứng xung_quanh xông hương , giơ khói lên mặt mình .	Mọi người đứng quanh hương, phả khói vào mặt.
A man using the bathroom mirror to tie his tie.	Một người dùng kính vệ sinh để thắt cà vạt.	Một người đàn ông đang sử dụng gương trong phòng tắm để thắt cà vạt.
Music being played by several individuals while a happy crowd sits and listens.	Được chơi nhạc bởi nhiều người trong khi đám đông vui vẻ ngồi và lắng nghe.	Âm nhạc được chơi bởi nhiều người trong khi đám đông vui vẻ ngồi và lắng nghe.
Two young men riding on a very small horse-drawn wagon full of potatoes.	Hai chàng trai trẻ cưỡi một chiếc xe ngựa nhỏ đầy khoai tây.	Hai thanh niên đang cưỡi trên một chiếc xe ngựa rất nhỏ chở đầy khoai tây.
A woman in a dress walking down the street past a construction site.	Một người phụ nữ mặc váy đi bộ trên phố qua một công trường.	Một người phụ nữ mặc váy đang đi bộ trên phố ngang qua một công trường xây dựng.
A clerk in a convenience store asks a customer buying alcohol for his age and identification.	Một nhân viên trong một cửa hàng tạp hóa xin khách hàng mua rượu cho tuổi tác và giấy tờ tùy thân.	Một nhân viên bán hàng tại một cửa hàng tiện lợi sẽ hỏi tuổi và giấy tờ tùy thân của khách hàng khi mua rượu.
A man with sunglasses is operating a construction automobile and releasing gravel on to the ground.	Một người đeo mặt nạ đang hoạt động một chiếc xe và phóng lên mặt đất.	Một người đàn ông đeo kính râm đang điều khiển xe thi công và rải sỏi xuống đất.
A baby playing with her toys looking at a black and white cat.	Một đứa bé chơi đùa với đồ chơi của nó nhìn vào một con mèo trắng đen.	Một em bé đang chơi đồ chơi và nhìn một chú mèo đen trắng.
A teenage girl is carrying a guitar in the woods.	Một thiếu nữ mang một cây đàn trong rừng.	Một cô gái tuổi teen đang mang theo một cây đàn guitar trong rừng.
A man wearing a backpack is walking down the street.	Một người đàn ông đeo ba lô đang đi trên đường.	Một người đàn ông đeo ba lô đang đi bộ trên phố.
Two men are having a conversation in front of a souvenir shop in Rome.	Hai người đàn ông đang nói chuyện trước cửa hàng kỷ niệm ở Rome.	Hai người đàn ông đang trò chuyện trước một cửa hàng lưu niệm ở Rome.
A woman in black is holding something in her mouth.	Một người phụ nữ mặc đồ đen đang ngậm cái gì đó trong miệng.	Một người phụ nữ mặc đồ đen đang ngậm thứ gì đó trong miệng.
A group of people sit outdoors around a small, short table.	Một nhóm người ngồi xung quanh một bàn nhỏ, ngắn.	Một nhóm người ngồi ngoài trời quanh một chiếc bàn nhỏ và ngắn.
A man riding his bike up the ramp.	Một người đàn ông đạp xe lên cao.	Một người đàn ông đang đạp xe lên dốc.
A woman wearing a black tank top and a cross necklace stares off into the distance near sunset.	Một người phụ nữ đeo một chiếc áo choàng màu đen và một cái nhìn chằm chằm vào khoảng cách gần mặt trời lặn.	Một người phụ nữ mặc áo ba lỗ màu đen và đeo vòng cổ hình thánh giá đang nhìn chằm chằm vào khoảng không xa xăm lúc hoàng hôn.
Three young girls are walking together down the sidewalk.	Ba cô gái trẻ đang đi cùng nhau trên vỉa hè.	Ba cô gái trẻ đang cùng nhau đi bộ trên vỉa hè.
A woman with long hair is at a graduation ceremony.	Một người phụ nữ có mái tóc dài đang dự lễ cưới.	Một người phụ nữ tóc dài đang tham dự lễ tốt nghiệp.
A man is skateboarding on a road while another man watches from the sidewalk.	Một người đàn ông đang đi trên một con đường trong khi một người đàn ông khác nhìn từ trên đường đi.	Một người đàn ông đang trượt ván trên đường trong khi một người đàn ông khác đứng xem từ vỉa hè.
A man in a black leather coat is standing in front of a sign.	Một người mặc áo khoác da màu đen đang đứng trước một dấu hiệu.	Một người đàn ông mặc áo khoác da màu đen đang đứng trước một biển hiệu.
A male and female singing a song together outside.	Một người nam và một nữ hát một bài ca với nhau bên ngoài.	Một nam và một nữ đang cùng nhau hát một bài hát ở bên ngoài.
A young girl with curly blond-hair and wearing a white top lies in the grass, holding a flower stem.	Một cô gái trẻ với tóc vàng xoăn và mặc một đầu trắng nằm trên cỏ, giữ một bông hoa.	Một cô gái trẻ với mái tóc vàng xoăn và mặc áo trắng nằm trên bãi cỏ, tay cầm một cành hoa.
A young women's soccer team with green uniforms is performing a stretching exercise.	Đội bóng nữ bóng với đồng phục xanh đang tập thể dục.	Một đội bóng đá nữ trẻ mặc đồng phục màu xanh lá cây đang thực hiện bài tập giãn cơ.
A woman acts out a dramatic scene in public behind yellow caution tape.	Một người phụ nữ diễn một vở kịch ở nơi công cộng phía sau băng ghi chú cẩn thận.	Một người phụ nữ đang diễn một cảnh kịch tính ở nơi công cộng sau dải băng cảnh báo màu vàng.
A man crouches while doing chores, as pigeons wander in the background.	Người nam đương làm việc lặt vặt, Như chim bồ câu đi dạo trong nền.	Một người đàn ông đang khom người làm việc nhà, trong khi đàn bồ câu bay lượn ở phía sau.
A group of men standing on a field of black balls.	Một nhóm đàn ông đứng trên một sân bóng đen.	Một nhóm đàn ông đứng trên một sân bóng đen.
A busy day for citizens at a local city court.	Một ngày bận rộn cho công dân tại một tòa án thành phố.	Một ngày bận rộn của người dân tại tòa án thành phố.
A man with a cigarette in his mouth fixing a plate of food.	Một người đàn ông với một điếu thuốc trong miệng của mình bán một đĩa thức ăn.	Một người đàn ông đang ngậm điếu thuốc trên miệng và chuẩn bị một đĩa thức ăn.
Two groups of swimmers wade out.	Hai nhóm người đi ra ngoài.	Hai nhóm người bơi ra ngoài.
People sit on a bench in a city square with random objects including a lamp and a dressmakers form standing nearby.	Người ta ngồi trên một cái ghế trong một quảng trường thành phố với những vật thể ngẫu nhiên, kể cả một cái đèn và một thợ may may may đứng gần đó.	Mọi người ngồi trên băng ghế ở quảng trường thành phố với những đồ vật ngẫu nhiên, bao gồm một chiếc đèn và một thợ may đứng gần đó.
The workers are surrounding a hole with a bucket.	Các công nhân đang ở trong một cái hố với một cái xô.	Những công nhân đang bao quanh một cái hố bằng một cái xô.
A shirtless man in black shorts is standing on the rocky shore to a large body of water.	Một người không mặc áo quần đen đang đứng trên bờ biển trên một vũng nước lớn.	Một người đàn ông cởi trần, mặc quần short đen đang đứng trên bờ đá cạnh một vùng nước lớn.
A guard is on the look out while on duty.	Lính gác đang trông chừng khi đang làm nhiệm vụ.	Một người lính đang canh gác trong lúc làm nhiệm vụ.
People playing pool, one is a man wearing a blue shirt and the others are women but their heads are not within the camera shot.	Mọi người chơi bida, một người đàn ông mặc áo sơ mi xanh và những người khác là phụ nữ nhưng đầu của họ không có trong máy quay.	Mọi người đang chơi bi-a, một người đàn ông mặc áo sơ mi xanh và những người khác là phụ nữ nhưng đầu của họ không nằm trong phạm vi chụp ảnh.
People are standing in front of a sculpture surrounded by water.	Mọi người đang đứng trước một bức tượng được bao quanh bởi nước.	Mọi người đang đứng trước một tác phẩm điêu khắc được bao quanh bởi nước.
A woman looks on as a man with folded arms is talking.	Một người phụ nữ nhìn như một người đàn ông đeo hai tay là nói chuyện.	Một người phụ nữ nhìn một người đàn ông khoanh tay đang nói chuyện.
Middle-aged man in white shorts and flip-flops looking up the road	Nam trung tuổi đàn ông trong trắng quần shorts trắng và lật lật nhìn lên đường	Người đàn ông trung niên mặc quần short trắng và dép tông nhìn lên đường
Two men dressed in dark orange coverings and sandals stand near a large reflective sculpture.	Có hai người đàn ông mặc bao phủ màu đen và đứng gần một bức tranh điêu khắc lớn.	Hai người đàn ông mặc đồ phủ màu cam sẫm và đi dép xăng đan đứng gần một tác phẩm điêu khắc phản chiếu lớn.
Two people are spending good time in their boat.	Hai người đang vui chơi trên thuyền.	Hai người đang tận hưởng khoảng thời gian vui vẻ trên thuyền.
A man and a woman are standing on the street in the city.	Một người đàn ông và một phụ nữ đang đứng trên đường phố trong thành phố.	Một người đàn ông và một người phụ nữ đang đứng trên đường phố trong thành phố.
Firemen emerge from a subway station.	Lính cứu hỏa chạy ra từ một ga tàu điện ngầm.	Lính cứu hỏa xuất hiện từ một ga tàu điện ngầm.
Four men, three of whom are wearing prayer caps, are sitting on a blue and olive green patterned mat.	Bốn người trong bọn họ có ba người đội khăn cầu nguyện, ngồi trên một tấm thảm xanh và xanh lá cây.	Bốn người đàn ông, trong đó có ba người đội mũ cầu nguyện, đang ngồi trên một tấm thảm có hoa văn màu xanh lam và xanh ô liu.
This is a large group of people sitting outside on benches.	Đây là một nhóm đông người đang ngồi bên ngoài.	Đây là một nhóm đông người đang ngồi ở bên ngoài trên băng ghế.
"A man in a red shirt walks past a turquoise and white checkered food establishment called ""32 De Neude."""	"Một người đàn ông mặc áo đỏ bước qua một cái máy chế biến thức ăn có dán thẻ trắng và trắng có tên là ""32 De NeIude."""	"Một người đàn ông mặc áo sơ mi đỏ đi ngang qua một cơ sở kinh doanh thực phẩm có họa tiết caro màu ngọc lam và trắng mang tên ""32 De Neude""."
Doctors performing some type of surgery.	Bác sĩ thực hiện một loại phẫu thuật.	Bác sĩ đang thực hiện một loại phẫu thuật nào đó.
An older man with a cigarette in his mouth and a ball cap inspects his camera.	Một người đàn ông lớn tuổi với một điếu thuốc trong miệng của mình và một quả bóng túi kiểm tra máy ảnh của mình.	Một người đàn ông lớn tuổi với điếu thuốc trên miệng và chiếc mũ lưỡi trai đang kiểm tra máy ảnh của mình.
Small orchestra playing with open violin case in front	Name	Dàn nhạc nhỏ chơi nhạc với hộp đàn violin mở ở phía trước
A man with a red suit is dancing with a lady.	Một người đàn ông với bộ đồ màu đỏ đang nhảy với một quý cô.	Một người đàn ông mặc bộ đồ đỏ đang khiêu vũ với một người phụ nữ.
Two people look on in the nighttime at the lights in a city.	Hai người nhìn vào ánh đèn trong một thành phố.	Hai người đang ngắm nhìn ánh đèn của một thành phố vào ban đêm.
Two motocross bikers wearing full protective gear, with one in midair after a jump and the other looking down at his motorcycle.	Hai đấu thủ mặc đồ bảo hộ đầy đủ dụng cụ bảo hộ, với một người trong khoảng không sau khi nhảy và người kia nhìn xuống chiếc xe máy của mình.	Hai người đi xe mô tô địa hình mặc đồ bảo hộ toàn thân, một người ở giữa không trung sau cú nhảy và người kia nhìn xuống chiếc xe máy của mình.
Several men dressed in orange gather for an outdoor social event.	Nhiều người đàn ông mặc quần áo màu da trong một buổi tiệc ngoài trời.	Một số người đàn ông mặc đồ màu cam tụ tập để tham gia một sự kiện xã hội ngoài trời.
Two young girls run on a sidewalk outside of a brick building with banners on it.	Hai cô gái trẻ chạy trên một vỉa hè bên ngoài một tòa nhà gạch với băng dán trên đó.	Hai cô gái trẻ chạy trên vỉa hè bên ngoài một tòa nhà gạch có treo biểu ngữ.
Two individual climbing up a steep mountain.	Có hai người leo lên dốc núi.	Hai người đang leo lên một ngọn núi dốc.
A child is laying on the ground next to a stroller.	Một đứa bé đang nằm trên mặt đất cạnh một chiếc xe đẩy.	Một đứa trẻ đang nằm trên mặt đất bên cạnh một chiếc xe đẩy.
A dog begging to a man and a woman.	Một con chó với một người đàn ông và một phụ nữ.	Một chú chó đang cầu xin một người đàn ông và một người phụ nữ.
A lot of people at the market looking at various different things.	Rất nhiều người tại thị trường nghiên cứu những thứ khác nhau.	Rất nhiều người ở chợ đang xem xét nhiều thứ khác nhau.
Two young men play electric guitars on stage.	Hai thanh niên chơi nhạc điện tử trên sân khấu.	Hai chàng trai trẻ chơi đàn ghi-ta điện trên sân khấu.
A tattooed man pouring beer out of a bottle into a young man's mouth.	Một người đàn ông rót bia ra khỏi chai rượu vào miệng một chàng trai trẻ.	Một người đàn ông xăm mình đang đổ bia từ chai vào miệng một thanh niên.
Two people standing outside next to blow up toys and dumpsters.	Hai người đứng bên ngoài cạnh để nổ tung đồ chơi và đạn pháo.	Hai người đứng bên ngoài cạnh nhau để thổi bay đồ chơi và thùng rác.
Four people are riding bicycles on a bike path near a busy street.	Bốn người đi xe đạp bằng xe đạp gần một con đường bận rộn.	Bốn người đang đạp xe trên đường dành cho xe đạp gần một con phố đông đúc.
Woman in a pink shirt and wearing glasses.	Một người đàn ông trong một chiếc áo sơ mi hồng và đeo kính.	Người phụ nữ mặc áo sơ mi hồng và đeo kính.
A woman in a red shirt raising her arm to the passing crowd below.	Một người phụ nữ mặc áo đỏ buộc tay vào đám đông bên dưới.	Một người phụ nữ mặc áo sơ mi đỏ giơ tay chào đám đông đang đi qua bên dưới.
A boy in white shorts is jumping into a lake or river.	Một cậu bé mặc quần đùi trắng đang nhảy xuống hồ hay sông.	Một cậu bé mặc quần đùi trắng đang nhảy xuống hồ hoặc sông.
A little girl is looking through a telescope at the beach.	Một cô bé đang nhìn qua kính thiên văn ở bờ biển.	Một bé gái đang nhìn bãi biển qua kính viễn vọng.
Several construction workers with orange safety vests are digging into the ground.	Những công nhân xây dựng với áo chống đạn được đào sâu xuống mặt đất.	Một số công nhân xây dựng mặc áo an toàn màu cam đang đào đất.
A person in a hood is standing in front of a run down building.	Một người đội mũ trùm đang đứng trước một tòa nhà sập.	Một người đội mũ trùm đầu đang đứng trước một tòa nhà đổ nát.
Construction workers picketing against PM Construction Services.	Công nhân đang chống lại dự án dự trữ.	Công nhân xây dựng biểu tình phản đối PM Construction Services.
A man riding a running horse with some other men doing the same behind him.	Một người đàn ông cưỡi ngựa với một số người đàn ông khác làm tương tự sau lưng anh ta.	Một người đàn ông cưỡi ngựa đang chạy với một số người đàn ông khác cũng làm như vậy phía sau anh ta.
An African American man walking down the street.	Một người đàn ông Châu Phi trên đường phố.	Một người đàn ông Mỹ gốc Phi đang đi bộ trên phố.
Two nuns are posing for a picture.	Hai nữ tu là cho một bức tranh.	Hai nữ tu đang tạo dáng chụp ảnh.
A woman with neon headphones writes in a notebook.	Một người phụ nữ với cái móc nối được viết trong một cuốn sổ tay.	Một người phụ nữ đeo tai nghe neon đang viết vào sổ tay.
A woman in a green-patterned shirt is talking on a cellphone.	Một người phụ nữ mặc áo sơ mi màu xanh đang nói chuyện với một cái điện thoại.	Một người phụ nữ mặc áo sơ mi họa tiết màu xanh lá cây đang nói chuyện trên điện thoại di động.
A small African child carries a younger child on his back.	Một đứa bé sơ sinh đang mang thai một đứa bé trên lưng.	Một đứa trẻ châu Phi nhỏ bé đang cõng một đứa trẻ nhỏ hơn trên lưng.
A group of people are sitting in chairs.	Một nhóm người đang ngồi trên ghế.	Một nhóm người đang ngồi trên ghế.
A person in a bandanna stands on the street in front his things.	Một người đứng trên đường trước đồ đạc của anh ta.	Một người đội khăn rằn đứng trên phố, trước mặt là đồ đạc của mình.
An oriental person in a red shirt and black pants crouching over a purse on concrete.	Một người bình thường mặc áo sơ mi đỏ và mặc quần đen đang khóc lóc trên một ví trên bê tông.	Một người phương Đông mặc áo sơ mi đỏ và quần đen đang khom người trên một chiếc ví trên bê tông.
A black dog and a brown dog with a ball.	Một con chó đen và một con chó nâu với một quả bóng.	Một con chó đen và một con chó nâu đang cầm một quả bóng.
A man with a black vest holding a model airplane	♪ Một người đàn ông với một chiếc áo màu đen ♪	Một người đàn ông mặc áo vest đen đang cầm một mô hình máy bay
A man in a field with an airplane in view.	Một người đàn ông trên một cánh đồng với một chiếc máy bay trong tầm ngắm.	Một người đàn ông trên cánh đồng và nhìn thấy một chiếc máy bay.
A man in a suit and tie and a woman with luggage join others in waiting in the London Underground.	Một người đàn ông mặc vest và cà vạt và một phụ nữ xách hành lý cùng với những người khác đang chờ đợi ở London.	Một người đàn ông mặc vest và thắt cà vạt cùng một người phụ nữ xách hành lý cùng những người khác đang chờ đợi ở ga tàu điện ngầm London.
A kid is walking down the sidewalk with a few American flags.	Một thằng nhóc đang đi dạo trên vỉa hè với vài lá cờ Mỹ.	Một đứa trẻ đang đi dọc vỉa hè với một vài lá cờ Mỹ.
A black dog runs on green grass with a toy in his mouth.	Một con chó đen chạy trên cỏ xanh với đồ chơi trong miệng.	Một con chó đen chạy trên bãi cỏ xanh với một món đồ chơi trong miệng.
An Oriental traveler awaits his turn at the currency exchange.	Một kẻ dâm đãng chờ đợi đến lượt mình trong cuộc trao đổi.	Một du khách phương Đông đang chờ đến lượt mình tại quầy đổi tiền.
A dog turns on the grass to persue a flying ball.	Một con chó quay trên cỏ để nhìn thấy một quả bóng bay.	Một chú chó chạy trên bãi cỏ để đuổi theo một quả bóng đang bay.
A group of students sit and listen to the speaker.	Một nhóm học viên ngồi và lắng nghe diễn giả.	Một nhóm sinh viên ngồi và lắng nghe diễn giả.
People are driving scooters down the street at night.	Mọi người đang lái xe trên phố vào ban đêm.	Mọi người lái xe tay ga trên phố vào ban đêm.
A large gray sea deck and a guy on the bike.	Một bãi biển lớn và một anh chàng trên xe đạp.	Một boong tàu lớn màu xám và một anh chàng đang đạp xe.
"A man in an orange shirt and a blond boy are riding with other people on a ""Pullman"" vehicle."	"Một người đàn ông mặc áo sơ mi màu cam và một chàng trai tóc vàng đang đi với những người khác trên chiếc xe ""Pullman""."	"Một người đàn ông mặc áo sơ mi màu cam và một cậu bé tóc vàng đang đi cùng những người khác trên chiếc xe ""Pullman""."
A young man and women near a large metal sculpture	Một người đàn ông và phụ nữ trẻ gần một bức tường kim loại lớn	Một chàng trai trẻ và một cô gái gần một tác phẩm điêu khắc kim loại lớn
A boat with red, white and blue sails docking at a pier.	Một chiếc thuyền có buồm màu đỏ, trắng và xanh đang đậu ở một bến tàu.	Một chiếc thuyền có cánh buồm màu đỏ, trắng và xanh đang neo đậu tại bến tàu.
A man wearing a black hat taking a photo in a busy street.	Một người đội mũ đen chụp ảnh trên một con đường đông đúc.	Một người đàn ông đội mũ đen đang chụp ảnh trên một con phố đông đúc.
A man is standing on a busy street looking with his head tilted up.	Một người đàn ông đang đứng trên một con đường bận rộn nhìn chằm chằm với cái đầu của anh ta bị nổ tung.	Một người đàn ông đang đứng trên một con phố đông đúc và nhìn với đầu ngẩng lên.
A woman in black has a little girl in a yellow dress on her shoulders.	Một phụ nữ mặc đồ đen có một cô bé mặc váy vàng trên vai.	Một người phụ nữ mặc đồ đen bế một bé gái mặc váy vàng trên vai.
A group of people on the street setting up instruments.	Một nhóm người trên đường đang chuẩn bị nhạc cụ.	Một nhóm người đang chuẩn bị nhạc cụ trên phố.
A fallen dirt biker is aided by another.	Một người máy hư hỏng được người khác giúp đỡ.	Một người đi xe đạp địa hình bị ngã được một người khác giúp đỡ.
Three people are walking up a mountain trail, while one woman is looking at her camera.	Ba người đang đi trên một dãy núi, trong khi một phụ nữ đang nhìn vào máy ảnh của cô ấy.	Ba người đang đi bộ lên một con đường mòn trên núi, trong khi một người phụ nữ đang nhìn vào máy ảnh.
Several Asian men wearing black clothing in some kind of station.	Nhiều người đàn ông Châu Á mặc quần áo đen trong một số loại trạm.	Một số người đàn ông châu Á mặc quần áo màu đen ở một trạm nào đó.
A woman in a red skirt is walking on the street with graffiti in the background.	Một người phụ nữ mặc váy đỏ đang đi bộ trên đường với vẽ trên nền.	Một người phụ nữ mặc váy đỏ đang đi trên phố với hình vẽ graffiti ở phía sau.
A rhythmic gymnast in a blue and pink outfit performs a ribbon routine.	Một nhịp điệu trong một bộ đồ màu xanh và màu hồng biểu diễn một lệ thường.	Một vận động viên thể dục nhịp điệu trong trang phục xanh và hồng đang biểu diễn động tác ruy băng.
People cooling off in a fountain, a woman in a white dress sits on the edge looking on.	Một phụ nữ mặc áo trắng ngồi trên mép nhìn.	Mọi người đang giải nhiệt dưới đài phun nước, một người phụ nữ mặc váy trắng ngồi trên mép đài phun nước nhìn xuống.
A man sitting on a bench under a large tree.	Một người đàn ông ngồi trên một băng ghế dưới một cây lớn.	Một người đàn ông đang ngồi trên băng ghế dưới một gốc cây lớn.
Three men in red and white striped shirts, white pants, and black hats hold flags.	Ba người đàn ông mặc áo sơ mi đỏ và trắng sọc, quần trắng, và mũ đen giữ cờ.	Ba người đàn ông mặc áo sơ mi sọc đỏ và trắng, quần trắng và mũ đen cầm cờ.
People are admiring a work of art.	Con người là một tác phẩm nghệ thuật.	Mọi người đang chiêm ngưỡng một tác phẩm nghệ thuật.
Busy Asian mall with paper lanterns and shoppers.	Ở khu buôn bán với giấy và quầy bán đồ.	Trung tâm thương mại Châu Á đông đúc với đèn lồng giấy và người mua sắm.
These people are climbing the steps to go the mountain	Những người này đang đi trên những bậc thang để đi trên ngọn núi	Những người này đang leo lên các bậc thang để lên núi
A small child in a blue outfit is looking off at some trees in the distance.	Một đứa trẻ mặc đồ xanh đang nhìn ra mấy cái cây đằng xa.	Một đứa trẻ nhỏ trong bộ đồ màu xanh đang nhìn về phía những cái cây ở đằng xa.
People are looking at children's toys in a store.	Mọi người đang nhìn đồ chơi trẻ em trong cửa hàng.	Mọi người đang xem đồ chơi trẻ em trong một cửa hàng.
A man with a hat is playing the drum in the street.	Một người đàn ông với một cái nón đang chơi trống trên đường phố.	Một người đàn ông đội mũ đang chơi trống trên phố.
A boy stands with three girls.	Một chàng trai đứng với ba cô gái.	Một cậu bé đứng cùng ba cô gái.
A smiling man wearing a backpack holds his fists up in front of a boy in glasses.	Một người đàn ông mỉm cười đeo một cái ba-lô giữ nắm đấm trước mặt một cậu bé đeo kính.	Một người đàn ông mỉm cười đeo ba lô giơ nắm đấm lên trước mặt một cậu bé đeo kính.
Four men are outside looking down over the green bridge they are on.	4 người đang ở ngoài nhìn xuống cầu xanh.	Bốn người đàn ông đang ở bên ngoài nhìn xuống cây cầu xanh nơi họ đang đứng.
A woman lounges on a towel in front of people enjoying the blue water.	Một người phụ nữ ngồi trên khăn trước mặt mọi người thưởng thức nước màu xanh.	Một người phụ nữ nằm trên một chiếc khăn trước mặt mọi người đang tận hưởng làn nước trong xanh.
An adult Australian Shepherd follows behind a running Australian Shepherd puppy.	Một người chăn chiên người Phi Châu đang chăn cừu đang chạy theo sau một con chó chăn cừu.	Một chú chó chăn cừu Úc trưởng thành chạy theo sau một chú chó chăn cừu Úc con.
Fall shoppers and bistro food lovers caught in the ebb and flow of the city.	Những người bán hàng và thức ăn thịnh soạn đã bị mắc kẹt trong dòng chảy của thành phố.	Những người mua sắm vào mùa thu và những người yêu thích ẩm thực quán rượu bị cuốn vào nhịp sống hối hả của thành phố.
The African American man protests against unlawful sex.	Người Mỹ gốc Mỹ phản đối việc quan hệ tình dục.	Người đàn ông Mỹ gốc Phi phản đối tình dục phi pháp.
A policeman is on a bike waiting for the light to change.	Một viên cảnh sát đang trên một chiếc xe đạp chờ đợi ánh sáng thay đổi.	Một cảnh sát đang đạp xe chờ đèn tín hiệu giao thông chuyển màu.
A group of men are sitting around a table.	Một nhóm đàn ông ngồi quanh bàn.	Một nhóm đàn ông đang ngồi quanh một cái bàn.
High class group of business people including older men have drinks in park.	Các thành viên cao cấp trong giới kinh doanh gồm cả các trưởng lão đều đãi rượu tại công viên.	Một nhóm doanh nhân cao cấp bao gồm cả những người đàn ông lớn tuổi đang uống rượu trong công viên.
Woman talking to friend while walking dog outside on a sunny day.	Đàn ông nói chuyện với bạn bè khi đang đi dạo với chó ngoài trời vào một ngày nắng.	Người phụ nữ đang nói chuyện với bạn trong khi dắt chó đi dạo bên ngoài vào một ngày nắng.
A young man wearing a gray and black shirt and a white headband	Một người đàn ông trẻ mặc một áo trắng trắng và áo sơ mi đen và một cái đầu trắng	Một chàng trai trẻ mặc áo sơ mi xám và đen và đội băng đô màu trắng
Two people are riding a motorcycle along with many other riders.	Hai người đang đi xe cùng với nhiều người khác.	Có hai người đang đi xe máy cùng với nhiều người khác.
Two women in military uniform are standing with other soldiers in formation.	Hai phụ nữ mặc quân phục đứng chung với những người lính khác trong đội hình.	Hai người phụ nữ mặc quân phục đang đứng cùng những người lính khác trong đội hình.
Three girls are smiling for a picture.	Ba cô gái đang cười cho một bức ảnh.	Ba cô gái đang mỉm cười chụp ảnh.
The lady wearing black rimmed glasses and a yellow sweater jacket looks confused as she sits on the tan covered bench.	Người phụ nữ đeo kính đen và áo khoác áo khoác màu vàng trông có vẻ lộn xộn khi cô ngồi trên băng bó da rám nắng.	Người phụ nữ đeo kính gọng đen và mặc áo khoác len màu vàng trông có vẻ bối rối khi ngồi trên chiếc ghế dài phủ màu rám nắng.
A red-haired young man drinks from a water fountain shaped like a woman.	Một chàng trai trẻ ngây thơ uống nước từ một nước giống như một người phụ nữ.	Một thanh niên tóc đỏ đang uống nước từ đài phun nước có hình dạng giống một người phụ nữ.
Two men and a woman are walking down a city street.	Hai người đàn ông và một phụ nữ đang đi trên một đường phố.	Hai người đàn ông và một người phụ nữ đang đi bộ trên phố.
A middle-aged man with red-hair and glasses holding an infant.	Một người đàn ông trung niên với cặp mắt đỏ và kính đang ôm một đứa trẻ sơ sinh.	Một người đàn ông trung niên tóc đỏ, đeo kính đang bế một đứa trẻ sơ sinh.
A young boy in a red hat rides on a horse.	Một cậu bé đội mũ đỏ cưỡi ngựa.	Một cậu bé đội mũ đỏ đang cưỡi ngựa.
Two boys are playing on the sidewalk.	Hai thằng nhóc đang chơi trên vỉa hè.	Hai cậu bé đang chơi trên vỉa hè.
A little girl wearing a black swimming suit holding a shovel at a beach.	Một bé gái mặc một bộ đồ bơi màu đen cầm một cái xẻng ở bãi biển.	Một bé gái mặc đồ bơi màu đen đang cầm xẻng trên bãi biển.
Old man wearing a hat and coat sleeping sitting up on a sofa.	Một người đàn ông già đội một cái mũ và áo khoác ngủ ngồi trên một chiếc sofa.	Một ông già đội mũ và mặc áo khoác đang ngủ ngồi trên ghế sofa.
Two boys are looking up at the sky and waving theirs arms and they are dressed in clothes to keep them warm.	Hai chàng trai nhìn lên bầu trời vẫy tay vẫy tay và họ mặc quần áo để giữ ấm.	Hai cậu bé đang nhìn lên bầu trời và vẫy tay, chúng mặc quần áo để giữ ấm.
A young couple sits on the sidewalk and relaxes together.	Một cặp vợ chồng trẻ ngồi trên lề đường và thư giãn cùng nhau.	Một cặp đôi trẻ ngồi trên vỉa hè và thư giãn cùng nhau.
A youth wearing a shirt and tie crouching down and giving the peace sign.	Một thanh niên mặc áo sơ mi và thắt lưng lại và biểu hiệu hòa bình.	Một thanh niên mặc áo sơ mi và cà vạt đang cúi xuống và giơ tay biểu tượng hòa bình.
Three people sitting at a table outside Bar Gelati Tabacchi.	Ba người ngồi tại bàn ăn bên ngoài quán rượu Geltatatatac.	Ba người ngồi ở một chiếc bàn bên ngoài quán Bar Gelati Tabacchi.
A boy in a black shirt and red wristbands hanging upside down while other people look on.	Một cậu bé mặc áo sơ mi đen và đeo găng tay đỏ treo ngược xuống trong khi những người khác nhìn vào.	Một cậu bé mặc áo sơ mi đen và đeo vòng tay màu đỏ treo ngược xuống trong khi những người khác nhìn vào.
A man walking in front of a colorful wall mural.	Một người đàn ông đi trước một bức tường đầy màu sắc.	Một người đàn ông đang đi trước bức tranh tường đầy màu sắc.
A young man walking with another young man glances back at three girls they just passed	Một người đàn ông trẻ đi dạo với một chàng trai trẻ khác liếc nhìn lại ba cô gái họ vừa qua đời	Một chàng trai trẻ đang đi cùng một chàng trai trẻ khác liếc nhìn lại ba cô gái mà họ vừa đi qua
A man trimming a palm tree inside a patio-type cafe'.	Một người đàn ông cắt một cây cọ bên trong một hình mẫu.	Một người đàn ông đang cắt tỉa cây cọ bên trong một quán cà phê ngoài trời.
Five people walking up a set of stairs led by a woman in a pink shirt and brown skirt.	Năm người đi bộ lên một cầu thang do một người phụ nữ mặc áo sơ mi màu hồng và váy nâu dẫn đầu.	Năm người đang bước lên cầu thang do một người phụ nữ mặc áo sơ mi hồng và váy nâu dẫn đầu.
A group of people at an outdoor fruit market	♪ Một nhóm người ở một thị trường ngoài trời ♪	Một nhóm người ở một chợ trái cây ngoài trời
Two boys eat their McDonalds lunch in an outdoor seating area surrounded by many other people.	Hai chàng trai ăn bữa trưa tại một khu vực ở ngoài trời xung quanh là nhiều người khác.	Hai cậu bé đang ăn trưa tại McDonalds ở khu vực chỗ ngồi ngoài trời, xung quanh có nhiều người khác.
A woman wearing a denim jacket walking along a sidewalk	♪ Một người phụ nữ mặc một cái áo khoác trắng	Một người phụ nữ mặc áo khoác denim đang đi dọc vỉa hè
A man driving a four wheeled vehicle with four passengers riding on the front and a man sitting sideways on the back.	Một người đàn ông lái một chiếc xe bốn bánh với bốn hành khách đi trên mặt trước và một người đàn ông ngồi một bên trên lưng.	Một người đàn ông đang lái một chiếc xe bốn bánh chở bốn hành khách ngồi ở phía trước và một người đàn ông ngồi nghiêng ở phía sau.
A man in a teal shirt reads a newspaper.	Một người đàn ông trong một cái đồng hồ đọc một tờ báo.	Một người đàn ông mặc áo sơ mi màu xanh ngọc đang đọc báo.
A boy in a stroller is wearing a green shirt and holding a book.	Một cậu bé trong xe đẩy mặc áo sơ mi màu xanh và cầm một cuốn sách.	Một cậu bé trong xe đẩy mặc áo sơ mi xanh và cầm một cuốn sách.
Two children sit side by side while eating a treat.	Hai con ngồi cạnh nhau trong khi ăn một bữa ăn.	Hai đứa trẻ ngồi cạnh nhau trong khi ăn đồ ăn vặt.
People are riding bicycles in the street, and they are all wearing helmets.	Người ta đi xe đạp trên đường phố, và họ đều đội mũ bảo hiểm.	Mọi người đang đi xe đạp trên phố và tất cả đều đội mũ bảo hiểm.
Crowds of people are all riding bicycles.	Rất nhiều người đều đạp xe đạp.	Đám đông người dân đều đang đạp xe.
A man seated on a platform with wheels is being pulled by a burrow.	Một người đàn ông ngồi trên một nền tảng với bánh xe đang bị kéo bởi một nút bấm.	Một người đàn ông ngồi trên một bệ có bánh xe đang được một cái hang kéo đi.
A man on a bicycle pedals through an archway.	Một người đàn ông trên một chiếc xe đạp băng qua một cái rãnh.	Một người đàn ông đạp xe qua một cổng vòm.
A colorfully dressed young man with visible skin lesions is sitting and smoking a cigarette.	Một thanh niên trẻ ăn mặc sặc sỡ với vết thương trên da đang ngồi hút thuốc.	Một thanh niên ăn mặc sặc sỡ với những tổn thương trên da rõ ràng đang ngồi hút thuốc.
Two men in suits under an umbrella and in front of graffiti.	Hai người đàn ông mặc đồ ngoài ô tô và ngay trước cổng.	Hai người đàn ông mặc vest đứng dưới một chiếc ô và trước bức tranh graffiti.
An old skinny man wearing the dirty white shirt riding on a bicycle on the street	Một người đàn ông già già già trẻ mặc áo áo trắng mặc áo trắng trắng mặc áo trên một xe đạp trên đường	Một ông già gầy gò mặc chiếc áo sơ mi trắng bẩn đang đạp xe trên phố
On horseback a man attempts to rope a young bull.	Trên một người đàn ông đang muốn treo cổ một con bò tơ.	Một người đàn ông đang cưỡi ngựa và cố gắng dùng dây thừng trói một con bò đực non.
A cowboy is attempting to lasso a calf while riding a horse.	Một chàng cao bồi muốn làm một con bò đực trong khi đang cưỡi một con ngựa.	Một chàng cao bồi đang cố gắng dùng thòng lọng để bắt bê con trong khi đang cưỡi ngựa.
Two bicyclists with helmets on are riding past some empty country fields.	Hai chiếc xe đạp có mũ bảo hiểm đang đi qua một số vùng đất trống.	Hai người đi xe đạp đội mũ bảo hiểm đang đi qua một cánh đồng quê vắng vẻ.
A man is leaning over and pulling something out of a bag.	Một người đàn ông đang dựa vào và kéo cái gì đó ra khỏi một cái túi.	Một người đàn ông đang cúi xuống và lấy thứ gì đó ra khỏi túi.
A man in a motor cart rides by to witness the park area.	Một người đàn ông đi xe đạp bằng xe đạp để làm chứng khu vực công viên.	Một người đàn ông đi xe ngựa đi ngang qua để ngắm cảnh khu vực công viên.
A person with tattoos is looking at a photo on a digital camera, or cellphone.	Một người có chức năng nhận dạng đang nhìn vào một bức ảnh trên một máy quay số, hoặc điện thoại di động.	Một người có hình xăm đang xem ảnh trên máy ảnh kỹ thuật số hoặc điện thoại di động.
A man in a black shirt and jeans standing on the sidewalk looking at the camera.	Một người đàn ông mặc áo sơ mi đen và mặc quần bó đứng trên vỉa hè nhìn vào máy ảnh.	Một người đàn ông mặc áo sơ mi đen và quần jean đứng trên vỉa hè nhìn vào máy ảnh.
A boy and girl standing together on the pavement as they look at an object.	Một cậu bé và cô bé đứng với nhau trên vỉa hè khi họ nhìn vào một đối tượng.	Một cậu bé và một cô bé đứng cùng nhau trên vỉa hè khi họ nhìn vào một vật thể.
Several people in blue scrubs and one in a skirt and black blouse.	Nhiều người mặc áo lót xanh và một người mặc váy màu đen.	Một số người mặc quần áo phẫu thuật màu xanh và một người mặc váy và áo cánh màu đen.
A woman and a dog sit on a white bench near a beach.	Một người phụ nữ và một con chó ngồi trên ghế trắng gần bãi biển.	Một người phụ nữ và một chú chó ngồi trên chiếc ghế dài màu trắng gần bãi biển.
Two women are walking in dirt outside a large building.	Hai phụ nữ đang đi trên đất liền bên ngoài một tòa nhà lớn.	Hai người phụ nữ đang đi trên đường đất bên ngoài một tòa nhà lớn.
A group of men and a child in white shirts are standing in the road.	Một nhóm đàn ông và một đứa trẻ mặc áo sơ mi trắng đang đứng trên đường.	Một nhóm đàn ông và một đứa trẻ mặc áo sơ mi trắng đang đứng trên đường.
A woman wearing all black and carrying a black bag on sidewalk	♪ Một người phụ nữ mặc tất cả đen và đeo một túi đen ♪	Một người phụ nữ mặc đồ đen và mang một chiếc túi đen trên vỉa hè
Group of men sitting around a table having a conversation.	Một nhóm đàn ông ngồi xung quanh một bàn có một cuộc trò chuyện.	Một nhóm đàn ông ngồi quanh bàn và trò chuyện.
A mural on the side of a building.	Một cái cột bên cạnh tòa nhà.	Một bức tranh tường trên mặt bên của một tòa nhà.
An Asian man wearing gloves is working at a food stall.	Một người đàn ông thực dụng đeo găng tay đang làm việc tại một cửa hàng thức ăn.	Một người đàn ông châu Á đeo găng tay đang làm việc tại một quầy hàng thực phẩm.
Woman sitting at a table while working on her laptop computer.	Người phụ nữ ngồi ở một bàn trong khi đang làm việc với máy tính xách tay của mình.	Người phụ nữ đang ngồi ở bàn trong khi làm việc trên máy tính xách tay.
A person is looking at the computer on a desk with a phone and a box.	Một người đang nhìn vào máy tính trên bàn với một điện thoại và một cái hộp.	Một người đang nhìn vào máy tính trên bàn cùng với một chiếc điện thoại và một chiếc hộp.
A man sits in a chair watching people stroll by.	Một người đàn ông ngồi trên một chiếc ghế xem mọi người đi qua.	Một người đàn ông ngồi trên ghế và ngắm nhìn mọi người đi qua.
Two people wearing hats are standing in a field tending to a crop.	Hai người đội mũ đội mũ đang đứng trong một hướng tới một vụ mùa.	Hai người đội mũ đang đứng trên cánh đồng chăm sóc cây trồng.
Some leaping over a high bar in Barcelona.	Có vài người ở quán bar trong quán bar.	Một số người đang nhảy qua thanh xà cao ở Barcelona.
A man dressed in boots and a cowboy hat sits atop a horse that is jumping while spectators sit in the stands.	Một người đàn ông mặc giày cao bồi và đội mũ cao bồi ngồi trên một chiếc mũ trên một con ngựa đang nhảy trong khi khán giả ngồi trên khán đài.	Một người đàn ông đi ủng và đội mũ cao bồi ngồi trên lưng ngựa đang nhảy trong khi khán giả ngồi trên khán đài.
Two young girls are sitting on the street eating corn.	Hai cô gái trẻ ngồi ngoài đường ăn ngô.	Hai cô gái trẻ đang ngồi ăn ngô trên phố.
Three children in football uniforms of two different teams are playing football on a football field, while another player and an adult stand in the background.	Ba đứa trẻ mặc đồng phục bóng bầu dục của hai đội khác nhau đang chơi bóng đá trên sân bóng trong khi một cầu thủ khác và một người lớn đứng ở sân sau.	Ba đứa trẻ mặc đồng phục bóng đá của hai đội khác nhau đang chơi bóng trên sân bóng, trong khi một cầu thủ khác và một người lớn đứng ở phía sau.
A young child with a dirty face being held by an old woman.	Một đứa trẻ với một khuôn mặt bẩn thỉu bị một bà già cầm giữ.	Một đứa trẻ với khuôn mặt bẩn thỉu đang được một bà già bế.
A man with glasses looks at camera while another man in a blue shirt looks intently at something.	Một người đeo kính nhìn vào máy quay trong khi một người đàn ông khác mặc áo màu xanh nhìn vào cái gì đó.	Một người đàn ông đeo kính nhìn vào máy ảnh trong khi một người đàn ông khác mặc áo sơ mi xanh đang chăm chú nhìn vào một thứ gì đó.
Two people sitting under a tree picking a green vegetable.	Hai người ngồi dưới một cái cây chọn một màu xanh lá cây.	Hai người đang ngồi dưới gốc cây hái rau xanh.
A young boy wearing a blue hat is looking through a telescope while another boy watches.	Một cậu bé đội mũ xanh đang nhìn qua kính thiên văn trong khi một cậu bé khác đồng hồ.	Một cậu bé đội mũ xanh đang nhìn qua kính viễn vọng trong khi một cậu bé khác đang quan sát.
3 men cooking in a small kitchen.	3 người đàn ông nấu ăn trong một nhà bếp nhỏ.	3 người đàn ông đang nấu ăn trong một căn bếp nhỏ.
A young girl wearing a gray snowsuit skiing on a snowy mountain.	Một cô gái trẻ mặc bộ đồ tuyết trắng trên núi tuyết.	Một cô gái trẻ mặc bộ đồ trượt tuyết màu xám đang trượt tuyết trên một ngọn núi tuyết.
A group of village women gathered in dance	Một nhóm các cô gái trong làng tụ tập lại trong khiêu vũ	Một nhóm phụ nữ trong làng tụ tập nhảy múa
A man and a woman are sorting through laundry with latex gloves on.	Một người đàn ông và một người phụ nữ đang chuẩn bị giặt ủi với đôi găng tay giả.	Một người đàn ông và một người phụ nữ đang phân loại quần áo giặt bằng găng tay cao su.
A young girl sitting on a wooden chair.	Một cô gái trẻ ngồi trên một chiếc ghế bằng gỗ.	Một cô gái trẻ đang ngồi trên một chiếc ghế gỗ.
Two workers weld the bars of a fence near a busy suburban street.	Hai công nhân hàn song sắt của một hàng rào gần một đường phố đông đúc.	Hai công nhân đang hàn các thanh hàng rào gần một con phố ngoại ô đông đúc.
A long-haired young man skateboarding on the rails on a cloudy day.	Một người đàn ông trẻ tuổi lang thang trên đường ray trong một ngày dài.	Một chàng trai tóc dài đang trượt ván trên đường ray vào một ngày nhiều mây.
In a outdoor market two men shovel snow and slush out of the path.	Trong một khu chợ ngoài trời, hai người đàn ông đi tuyết và đi ra khỏi con đường.	Tại một khu chợ ngoài trời, hai người đàn ông đang xúc tuyết và dọn bùn khỏi lối đi.
A guy wearing a white shirt is playing a white guitar.	Một gã mặc áo sơ mi trắng đang chơi guitar trắng.	Một chàng trai mặc áo sơ mi trắng đang chơi đàn ghita trắng.
A young girl shows her friends how to use a disposable camera.	Một cô gái trẻ chỉ cho bạn bè cách sử dụng máy ảnh.	Một cô gái trẻ đang hướng dẫn bạn bè cách sử dụng máy ảnh dùng một lần.
A little boy jumping off of a dock into a lake.	Một cậu bé nhảy ra khỏi một bến tàu vào một cái hồ.	Một cậu bé nhảy từ bến tàu xuống hồ.
Lady with a green mask at the dentist and she just look very unhappy.	Cô gái đeo mặt nạ xanh ở nha sĩ và cô ấy trông rất buồn.	Người phụ nữ đeo khẩu trang màu xanh lá cây ở nha sĩ và trông rất không vui.
A man with an orange jacket and blue hat climbing a snowy mountain.	Một người đàn ông với một áo khoác màu cam và màu xanh trắng lên một núi tuyết.	Một người đàn ông mặc áo khoác màu cam và mũ xanh đang leo núi tuyết.
A little girl with blond-hair is playing and splashing in a mud puddle.	Một cô bé tóc vàng đang chơi đùa và bắn nhau trong vũng bùn.	Một cô bé tóc vàng đang chơi đùa và té nước trong vũng bùn.
A child is riding a bike down an alleyway with graffiti in it.	Một đứa trẻ đang đi xe đạp xuống một con hẻm với một con hẻm trong đó.	Một đứa trẻ đang đạp xe xuống một con hẻm có nhiều hình vẽ graffiti.
A gymnast is being judged at en event.	Một người đang bị xét xử tại trường hợp sau đó.	Một vận động viên thể dục dụng cụ đang được đánh giá tại một sự kiện.
People walking down the street with a street vendor.	Những người đi bộ trên phố với một nhà băng.	Mọi người đang đi bộ trên phố cùng một người bán hàng rong.
Man clothed in a traditional dress like attire, while standing next to his mule who also seems to be clothed as well.	Người đàn ông mặc váy truyền thống giống như quần áo, trong khi đứng bên cạnh của mình con la dường như cũng được mặc quần áo.	Người đàn ông mặc trang phục truyền thống, đứng cạnh con la của mình và dường như cũng đang mặc quần áo.
Two children are playing on a bicycle.	Hai đứa trẻ đang chơi trên một chiếc xe đạp.	Hai đứa trẻ đang chơi trên xe đạp.
Two men on opposing teams are playing soccer in a field.	Hai cầu thủ bóng đá đang chơi trên sân bóng.	Hai người đàn ông ở hai đội đối thủ đang chơi bóng đá trên một sân bóng.
A man jumps and poses for photographers lying on the ground.	Một người đàn ông nhảy múa và trở thành nhiếp ảnh gia nằm trên mặt đất.	Một người đàn ông nhảy và tạo dáng cho các nhiếp ảnh gia khi đang nằm trên mặt đất.
The girl is taking a drink from a water fountain.	Cô gái đang uống nước hồ.	Cô gái đang uống nước từ vòi phun nước.
The spelunker finds water during his trek.	Nhà vệ sinh tìm thấy nước trong suốt thời gian ông ấy đi.	Người thám hiểm hang động tìm thấy nước trong chuyến đi của mình.
A man in a lab coat is looking through a microscope.	Một người mặc áo choàng trong phòng thí nghiệm đang nhìn xuyên qua một cái kính hiển vi.	Một người đàn ông mặc áo khoác phòng thí nghiệm đang nhìn qua kính hiển vi.
A blond girl sleeps on a brown couch.	Một cô gái tóc vàng ngủ trên ghế nâu.	Một cô gái tóc vàng ngủ trên chiếc ghế dài màu nâu.
A man sweeps a sidewalk outside of a brick building during the day.	Ban ngày, người ta quét một vỉa hè bên ngoài tòa nhà gạch.	Một người đàn ông đang quét vỉa hè bên ngoài một tòa nhà gạch vào ban ngày.
Three men are cooking in a kitchen.	Ba người đàn ông đang nấu ăn trong một nhà bếp.	Ba người đàn ông đang nấu ăn trong bếp.
A man on a scaffold in front of a house is smiling and posing for the photographer.	Một người đàn ông đứng trên một cái sạp trước một ngôi nhà là cười và cung cấp cho nhiếp ảnh gia.	Một người đàn ông đứng trên giàn giáo trước ngôi nhà đang mỉm cười và tạo dáng để chụp ảnh.
Two girls in shorts are holding hands at a pool.	Hai cô gái mặc quần đùi đang nắm tay nhau ở một hồ bơi.	Hai cô gái mặc quần short đang nắm tay nhau ở hồ bơi.
Four Asian kids sit on a bench and wave and smile to the camera.	Bốn đứa trẻ Châu Á ngồi trên băng ghế dài và vẫy tay và mỉm cười với máy ảnh.	Bốn đứa trẻ châu Á ngồi trên băng ghế, vẫy tay và mỉm cười với máy ảnh.
Children ride bikes in what appears to be an impoverished nation.	Trẻ em đi xe đạp ở nơi có vẻ như là một quốc gia.	Trẻ em đi xe đạp ở một quốc gia có vẻ như nghèo đói.
A young boy, wearing a chef's hat and apron, is cutting sausages in a kitchen.	Một chàng trai trẻ, đội mũ bếp trưởng và áo dài, là xúc xích cắt trong nhà bếp.	Một cậu bé đội mũ đầu bếp và đeo tạp dề đang cắt xúc xích trong bếp.
This is a clown at an elementary school.	Đây là một thằng hề ở trường tiểu học.	Đây là một chú hề ở một trường tiểu học.
The smiling ship captain is holding the wheel of his wooden ship.	Thuyền trưởng đang nắm tay lái của chiếc tàu gỗ của mình.	Người thuyền trưởng đang mỉm cười khi cầm bánh lái của con tàu gỗ.
A yellow bulldozer working to move dirt.	Một con xe ủi màu vàng làm việc để di chuyển đất.	Một chiếc xe ủi đất màu vàng đang di chuyển đất.
A woman in a red shirt is riding an all white horse that is galloping along the trees.	Một người phụ nữ mặc áo sơ mi màu đỏ đang cưỡi một con ngựa bạch đang đu đưa trên cây.	Một người phụ nữ mặc áo sơ mi đỏ đang cưỡi một con ngựa toàn màu trắng phi nước đại dọc theo những hàng cây.
A woman sitting on a very large rock smiling at the camera with trees in the background.	Một người phụ nữ ngồi trên một tảng đá rất lớn mỉm cười với máy ảnh với cây ở phía sau.	Một người phụ nữ đang ngồi trên một tảng đá rất lớn, mỉm cười với máy ảnh, phía sau là những cái cây.
Three men wearing brightly colored costumes take to the streets with wigs and crazy sunglasses.	Ba người đàn ông ăn mặc bảnh bao ra đường với tóc giả và sự điên cuồng.	Ba người đàn ông mặc trang phục nhiều màu sắc đi ra đường với tóc giả và kính râm kỳ quặc.
A girl plays in a small pool.	Một cô gái chơi trong một nhóm nhỏ.	Một cô gái đang chơi trong một hồ bơi nhỏ.
Two children, a boy in a yellow shirt and a girl in blue and white stripes, swinging.	Hai đứa trẻ, một cậu bé mặc áo vàng và một cô gái mặc áo xanh trắng, đung đưa.	Hai đứa trẻ, một bé trai mặc áo sơ mi vàng và một bé gái mặc áo sọc xanh trắng, đang đu đưa.
A man throws a fishing net into the bay.	Người ta thảy lưới vào vịnh.	Một người đàn ông đang ném lưới đánh cá xuống vịnh.
A man wearing a gray shirt, blue jeans and a neon green safety vest is standing on a railroad track with a white truck and a white building in the background.	Một người đàn ông mặc áo sơ mi, quần lót xanh và áo bảo vệ màu xanh da trời đang đứng trên đường ray với một xe tải trắng và một tòa nhà màu trắng phía sau.	Một người đàn ông mặc áo sơ mi xám, quần jean xanh và áo phao màu xanh neon đang đứng trên đường ray xe lửa với một chiếc xe tải màu trắng và một tòa nhà màu trắng ở phía sau.
Two construction workers are laying sheet metal across beams.	Hai công nhân xây dựng đang lắp ráp các miếng kim loại dọc theo nhau.	Hai công nhân xây dựng đang đặt tấm kim loại lên các thanh dầm.
There is a band on stage with band members wearing hints of blue.	Có một ban nhạc trên sân khấu với các thành viên ban nhạc gợi ý về màu xanh.	Có một ban nhạc trên sân khấu với các thành viên mặc trang phục màu xanh.
A rocker with his shirt off sings into a microphone while he plays the drums.	Một kẻ say mê với cái áo ngực của hắn hát vang lên trong khi hắn chơi trống.	Một nhạc sĩ nhạc rock cởi trần hát vào micro trong khi chơi trống.
I see a man putting his items from the shopping cart, ready to be checked out.	Tôi thấy một người đàn ông đặt hàng của mình từ xe hàng, sẵn sàng để được kiểm tra.	Tôi thấy một người đàn ông đang bỏ đồ vào xe đẩy mua sắm, chuẩn bị thanh toán.
The man with the cane is on a walk.	Người cầm gậy đang đi dạo.	Người đàn ông cầm gậy đang đi bộ.
A woman wearing a white shirt works out on an elliptical machine.	Một người phụ nữ mặc áo sơ mi trắng làm việc trên một máy đo âm đạo.	Một người phụ nữ mặc áo sơ mi trắng đang tập luyện trên máy tập elip.
A girl wearing a mask rides on a man's shoulders through a crowded sidewalk.	Một cô gái đeo mặt nạ đi trên vai một người đàn ông qua một con đường đông đúc.	Một cô gái đeo mặt nạ ngồi trên vai một người đàn ông đi qua vỉa hè đông đúc.
Two girls, one older and in black and one younger and in white, are performing the same ballet move in front of decorations made from balloons.	Hai bé gái, một lớn tuổi hơn và da đen và một trẻ và trắng, đang biểu diễn cùng một điệu ba - lê trước mặt những đồ trang trí bằng bóng bay.	Hai cô gái, một lớn tuổi hơn mặc đồ đen và một nhỏ tuổi hơn mặc đồ trắng, đang biểu diễn cùng một động tác ba lê trước những vật trang trí làm từ bóng bay.
Several women are performing a dance in front of a building.	Nhiều phụ nữ đang biểu diễn một điệu nhảy trước một tòa nhà.	Một số phụ nữ đang biểu diễn khiêu vũ trước một tòa nhà.
A bald man walking down a city sidewalk while talking on his cellphone.	Một người đàn ông hói đi xuống một thành phố vỉa hè trong khi nói chuyện trên điện thoại của mình.	Một người đàn ông hói đang đi bộ trên vỉa hè thành phố trong khi nói chuyện trên điện thoại di động.
A woman plays with finger puppets as a small child in a costume walks by.	Một người phụ nữ chơi với những con rối ngón tay như một đứa trẻ trong một bộ trang phục đi qua.	Một người phụ nữ đang chơi rối ngón tay trong khi một đứa trẻ mặc trang phục hóa trang đi ngang qua.
A group of people watch young men play the drums using makeshift buckets as instruments.	Một nhóm người xem những chàng trai trẻ chơi trống bằng cách làm những cái xô như một nhạc cụ.	Một nhóm người đang xem những chàng trai trẻ chơi trống bằng cách sử dụng những chiếc xô tự chế làm nhạc cụ.
A girl with normal and improvised safety gear rollerblades.	Một cô gái bình thường.	Một cô gái với thiết bị an toàn thông thường và tự chế khi đi giày trượt patin.
A small white car is on the train tracks and may or may not have been hit by the train behind it.	Một chiếc xe nhỏ màu trắng đang ở trên đường ray và có thể hoặc có thể đã không bị xe lửa đâm sau nó.	Một chiếc ô tô nhỏ màu trắng nằm trên đường ray xe lửa và có thể đã bị đoàn tàu phía sau đâm phải hoặc không.
Two rockers are singing and playing on a dark stage.	Hai nhạc sĩ đang hát và đang chơi trên một sân khấu tối.	Hai ca sĩ nhạc rock đang hát và chơi nhạc trên một sân khấu tối.
A girl wearing a baseball cap, white t-shirt and blue shorts is standing in a rock-bottomed, forest-lined mountain stream.	Một cô gái đội mũ bóng chày, áo thun trắng và quần ngắn màu xanh đang đứng trên một con đường rừng rậm.	Một cô gái đội mũ bóng chày, mặc áo phông trắng và quần short xanh đang đứng ở một con suối trên núi có đáy đá, xung quanh là rừng cây.
Two men playing guitar in front of a large audience.	Hai người đàn ông chơi guitar trước một khán giả đông đảo.	Hai người đàn ông đang chơi đàn ghi-ta trước đông đảo khán giả.
A number of people are dancing with their significant others in front of this huge house.	Một số người đang nhảy múa với những người nổi tiếng khác ngay trước ngôi nhà khổng lồ này.	Một số người đang khiêu vũ với người yêu của mình trước ngôi nhà lớn này.
Woman and dog selling her wares on the old building steps outside.	Và người phụ nữ bán hàng của mình trên những bậc thang tòa nhà cũ bên ngoài.	Người phụ nữ và chú chó đang bán hàng trên bậc thang bên ngoài tòa nhà cũ.
A woman and two men, that are dressed professionally, are having a discussion.	Một người đàn bà và hai người đàn ông ăn mặc chuyên nghiệp đang thảo luận.	Một người phụ nữ và hai người đàn ông ăn mặc chuyên nghiệp đang thảo luận.
A group of men in red and black jackets waits on motorcycles.	Một nhóm người mặc áo khoác đỏ đen đang chờ trên xe máy.	Một nhóm đàn ông mặc áo khoác đỏ và đen đang đợi trên xe máy.
A guy dressed in a white uniform with a number 3 on it playing soccer.	Một gã mặc đồng phục trắng với số 3 trên đó đang chơi bóng đá.	Một chàng trai mặc đồng phục màu trắng có số 3 đang chơi bóng đá.
A man is selling snacks at a sporting event.	Một người đàn ông đang bán đồ ăn tại một buổi tiệc.	Một người đàn ông đang bán đồ ăn nhẹ tại một sự kiện thể thao.
Two males from the green team tackles the other members from black team for the ball in a game of rugby.	Hai nam từ đội bóng xanh, các thành viên khác từ đội đen cho quả bóng trong một trò chơi bóng bầu dục.	Hai thành viên nam của đội xanh tranh bóng với các thành viên còn lại của đội đen trong một trận bóng bầu dục.
Kids compete to gain possession of the soccer ball.	Những đứa trẻ để có được bóng đá.	Trẻ em thi nhau giành quyền sở hữu quả bóng đá.
A person in blue is the only person currently throwing their ball at a bowling alley.	Một người mặc đồ xanh là người duy nhất ném bóng tại một con hẻm.	Người mặc đồ xanh là người duy nhất đang ném bóng vào đường bowling.
Several football players on a field in action.	Cầu thủ bóng đá đang trên sân đấu.	Một số cầu thủ bóng đá đang thi đấu trên sân.
Young man sitting on a skateboard, holding a cellphone, and posing on the escalator.	Người trẻ tuổi ngồi trên ghế, cầm một cái điện thoại, và ngồi trên thang máy.	Một chàng trai trẻ ngồi trên ván trượt, cầm điện thoại di động và tạo dáng trên thang cuốn.
A lady dressed in blue running a marathon.	Một quý cô mặc áo xanh đang chạy đua.	Một người phụ nữ mặc đồ xanh đang chạy marathon.
This band is getting ready to perform in front of an audience at church.	Ban nhạc này đang chuẩn bị trình diễn trước khán giả tại nhà thờ.	Ban nhạc này đang chuẩn bị biểu diễn trước khán giả tại nhà thờ.
# 8 for Iowa State stiff arms a Texas AM player attempting to tackle him.	# 8 cho thằng tiểu bang Iowa đang cầm vũ khí của một kẻ chơi chữ Texas đang cố hạ gục hắn.	#8 cho đội Iowa State đã cố tình cản phá một cầu thủ Texas AM đang cố gắng truy cản anh ta.
Two male curling players are on ice sweeping the path in front of polished rock, a small crowd watches.	Hai cầu thủ khúc quanh nam đang trên băng trượt trên con đường đi vào phía trước tảng đá, một đám đông nhỏ canh gác.	Hai vận động viên nam chơi môn bi đá trên băng đang quét lối đi phía trước tảng đá bóng loáng, một đám đông nhỏ đang theo dõi.
Men play soccer on a muddy field.	Đàn ông chơi trên một sân chơi.	Những người đàn ông chơi bóng đá trên một sân lầy lội.
A basketball player in white squats while a player in red moves toward him.	Một cầu thủ bóng bóng trong khi một cầu thủ màu đỏ di chuyển về phía anh ta.	Một cầu thủ bóng rổ mặc đồ trắng ngồi xổm trong khi một cầu thủ mặc đồ đỏ di chuyển về phía anh ta.
People walk through an arch in an old-looking city.	Những người đi xuyên qua một cái vòm trong một thành phố cổ xưa.	Mọi người đi qua một mái vòm trong một thành phố cổ kính.
Two race cars, one red and one blue, are driving side by side down a racetrack while being watched by several onlookers.	Hai xe đua, một xe màu đỏ và một màu xanh, đang di chuyển bên cạnh nhau trên đường đua trong khi có nhiều người theo dõi.	Hai chiếc xe đua, một chiếc màu đỏ và một chiếc màu xanh, đang chạy song song trên đường đua trong khi có nhiều người chứng kiến ​​đang theo dõi.
A football player in a white uniform is holding a football.	Một cầu thủ bóng đá mặc đồng phục trắng đang cầm bóng bầu dục.	Một cầu thủ bóng đá mặc đồng phục màu trắng đang cầm một quả bóng đá.
A very young boy stares ahead as he is biting onto a small object.	Một cậu bé nhìn về phía trước khi nhìn vào một vật nhỏ bé.	Một cậu bé rất nhỏ đang nhìn về phía trước trong khi đang cắn một vật nhỏ.
A woman and a child are walking down a street.	Một phụ nữ và một đứa trẻ đang đi trên một con đường.	Một người phụ nữ và một đứa trẻ đang đi bộ trên phố.
A hockey game is being played with lots of people watching it.	Một trò chơi khúc côn cầu đang được chơi với rất nhiều người xem nó.	Một trận đấu khúc côn cầu đang diễn ra với rất nhiều người đến xem.
Three woman bouncing on balls in the grass.	Ba người phụ nữ trên bi trên bãi cỏ.	Ba người phụ nữ đang chơi bóng trên cỏ.
An African-American boy wearing blue shorts, a black and red shirt, and white sneakers, is playing tennis.	Một chàng trai Mỹ gốc Phi mặc quần ngắn màu xanh dương, một áo sơ mi đen và đỏ, và quần trắng, đang chơi tennis.	Một cậu bé người Mỹ gốc Phi mặc quần short xanh, áo sơ mi đen và đỏ, đi giày thể thao trắng đang chơi quần vợt.
A man and a woman in white shirts are hugging each other.	Một người đàn ông và một người phụ nữ mặc áo trắng đang ôm nhau.	Một người đàn ông và một người phụ nữ mặc áo sơ mi trắng đang ôm nhau.
A man talking to a family unit holding some sort of probing device as they look on and smile to be polite.	Một người đàn ông nói chuyện với một đơn vị gia đình đang cầm một thiết bị thăm dò khi họ nhìn vào và cười để lịch sự.	Một người đàn ông đang nói chuyện với một gia đình, tay cầm một loại thiết bị thăm dò nào đó khi họ nhìn và mỉm cười lịch sự.
Very young boy in a green shirt laying face down on a white bed.	Một chàng trai trẻ mặc áo sơ mi xanh nằm úp mặt xuống giường trắng.	Cậu bé rất trẻ mặc áo sơ mi xanh nằm sấp trên giường trắng.
An extreme cyclist stops to rest as the sun sets in the background.	Một di tích siêu tốc để nghỉ ngơi khi mặt trời lặn ở phía sau.	Một người đi xe đạp mạo hiểm dừng lại để nghỉ ngơi khi mặt trời lặn ở phía sau.
A woman is skying in a snowy area wearing warm clothing.	Một người phụ nữ đang lướt sóng trên một vùng tuyết với quần áo ấm.	Một người phụ nữ đang nhảy dù ở vùng tuyết phủ và mặc quần áo ấm.
Four girls and a lady learning how to do some crafts.	Bốn cô gái và một phụ nữ học cách làm một số nghề.	Bốn cô gái và một người phụ nữ đang học cách làm đồ thủ công.
A man wearing black and white stripes is trying to stop a horse.	Một người đàn ông mặc quân phục trắng đen đang cố ngăn chặn một con ngựa.	Một người đàn ông mặc đồ sọc đen trắng đang cố gắng chặn một con ngựa.
The gentleman is scanning the image that the woman in the blue shirt is providing him.	Đây là hình ảnh mà người phụ nữ mặc áo xanh đang tặng anh ta.	Người đàn ông đang xem hình ảnh mà người phụ nữ mặc áo sơ mi xanh cung cấp cho anh ta.
A woman with red-hair is neck deep in cloudy blue water.	Một người phụ nữ với màu đỏ là cổ trong nước biển.	Một người phụ nữ tóc đỏ đang ngụp mình trong làn nước xanh đục, ngập đến cổ.
Two young boys pose with a puppy for a family picture.	Hai chàng trai trẻ làm nghề chăn cừu cho gia đình.	Hai cậu bé tạo dáng chụp ảnh gia đình cùng một chú chó con.
Four children practice karate while two adults watch.	thói quen tập thể dục khi hai người trưởng thành.	Bốn đứa trẻ tập karate trong khi hai người lớn quan sát.
A man lounges on a red sofa in a furniture showroom.	Một người đàn ông ngồi trên một chiếc ghế sofa màu đỏ trong một buổi trưng bày.	Một người đàn ông đang nằm dài trên chiếc ghế sofa màu đỏ trong một phòng trưng bày đồ nội thất.
A group of people talking at tables.	Một nhóm người nói chuyện với nhau ở bàn.	Một nhóm người đang nói chuyện ở bàn.
Two horse racing jockeys, one in checkered blue and red and the other in orange and brown, are racing against a blurry background.	Hai đấu thủ đua ngựa, một trong tinh chỉnh màu xanh và màu đỏ và khác màu cam và màu nâu, đang chống lại một hình nền.	Hai kỵ sĩ đua ngựa, một người mặc đồ kẻ ô vuông màu xanh và đỏ, người kia mặc đồ màu cam và nâu, đang đua với phông nền mờ.
The red car is ahead of the two cars in the background.	Chiếc xe màu đỏ ở phía trước hai chiếc xe phía sau.	Chiếc xe màu đỏ chạy phía trước hai chiếc xe phía sau.
A large bull targets a man, inches away, in a rodeo with his horns, while a rodeo clown runs to help.	Một con bò đực lớn nhắm vào một người, cách đó vài phân, trong một cái sừng có sừng, trong khi một con chim cu chạy đến giúp đỡ.	Một con bò đực lớn nhắm vào một người đàn ông cách đó vài inch trong một cuộc thi đấu rodeo bằng cặp sừng của nó, trong khi một chú hề rodeo chạy đến giúp đỡ.
A shirtless man walks toward a yellow kayak.	Một người đàn ông không mặc áo sơ mi bước ra trước một kẻ mặc áo cao su.	Một người đàn ông cởi trần bước về phía chiếc thuyền kayak màu vàng.
A boy at a gun range aims and shoots.	Một thằng nhóc ngắm bắn súng và bắn.	Một cậu bé đang ngắm và bắn ở trường bắn.
Two teams of boys playing football in the sand.	Hai đội bóng đá trên bãi cát.	Hai đội nam đang chơi bóng đá trên cát.
A child in blue and a child in white stand on a short concrete wall by a stream.	Một đứa trẻ mặc áo xanh và một đứa trẻ mặc áo trắng đứng trên một bức tường bằng gạch lát cạnh một dòng suối.	Một đứa trẻ mặc đồ xanh và một đứa trẻ mặc đồ trắng đứng trên bức tường bê tông ngắn bên cạnh một dòng suối.
A woman draws a floral design on a clay pot.	Một người phụ nữ vẽ hoa trên nồi đất sét.	Một người phụ nữ đang vẽ họa tiết hoa trên một chiếc bình đất sét.
People are walking down a busy street in a foreign country.	Người ta đi bộ trên một con đường đông đúc ở nước ngoài.	Mọi người đang đi bộ trên một con phố đông đúc ở một đất nước xa lạ.
A right-handed pitcher for the Saints is throwing a pitch.	Một người thuận tay phải cho các Thánh đấu sĩ đang ném bóng.	Một cầu thủ ném bóng thuận tay phải của đội Saints đang ném bóng.
Two men, one in black and white and one in red, are playing beach volleyball.	Hai người đàn ông, một màu đen trắng và một màu đỏ, đang chơi trên bãi biển.	Hai người đàn ông, một người mặc đồ đen trắng và một người mặc đồ đỏ, đang chơi bóng chuyền bãi biển.
A man is standing in a boat holding some netting.	Một người đàn ông đang đứng trên một chiếc thuyền đang nắm giữ một số mạng lưới.	Một người đàn ông đang đứng trên thuyền và cầm một tấm lưới.
A surfer who fell off his surfboard in the ocean while trying to ride a wave.	Air người đã rơi khỏi ván trượt của mình trên biển trong khi cố gắng lên sóng.	Một người lướt sóng bị ngã khỏi ván lướt sóng ở biển khi đang cố gắng cưỡi sóng.
A technician preparing a sample in the lab.	Một người đang chuẩn bị mẫu trong phòng thí nghiệm.	Một kỹ thuật viên đang chuẩn bị mẫu trong phòng thí nghiệm.
Soccer players are jumping in the air to hit the ball with their heads.	Những vận động viên chuyên nghiệp đang nhảy vào không khí để đập bóng với cái đầu của họ.	Các cầu thủ bóng đá nhảy lên không trung để đánh bóng bằng đầu.
Two boys play soccer against each other.	Hai thằng con trai chơi bóng đá với nhau.	Hai cậu bé chơi bóng đá với nhau.
An elderly person is crossing a street with an umbrella in their hands.	Một người lớn tuổi đang băng qua đường với một cái nắm tay trên tay.	Một người lớn tuổi đang băng qua đường với chiếc ô trên tay.
A group of runners are running towards two identical skyscrapers.	Một nhóm những người đang chạy đến hai lần tương đương nhau.	Một nhóm người chạy về phía hai tòa nhà chọc trời giống hệt nhau.
A skateboarder rides up a concrete wall, nearly falling off as he tries a trick.	Một người trượt ván leo lên một bức tường bê tông, gần như rơi ra khi anh ta thử một trò lừa.	Một người trượt ván đang trượt lên bức tường bê tông, gần như ngã xuống khi đang thử một động tác.
People playing a game in the pool.	Những người chơi một trò chơi trong hồ bơi.	Mọi người đang chơi trò chơi trong hồ bơi.
A guy give a kiss to a guy also	♪ A guy đưa một nụ hôn cho một anh chàng	Một chàng trai cũng trao cho một chàng trai một nụ hôn
A man signs an autograph in a young boy's book.	Một người đàn ông ký một chữ ký trong một cuốn sách của một chàng trai trẻ.	Một người đàn ông ký tặng vào cuốn sách dành cho một cậu bé.
A young man in a blue shirt grinds a rail on a skateboard in an urban area.	Một thanh niên mặc áo sơ mi màu xanh đang đi trên một con đường nhỏ trong khu vực đô thị.	Một thanh niên mặc áo sơ mi xanh đang trượt ván trên đường ray ở khu vực thành thị.
An Asian man sits on the tracks with crates of peanuts.	Một người đàn ông châu Á ngồi trên đường ray với những thùng đậu phộng.	Một người đàn ông châu Á ngồi trên đường ray với những thùng đậu phộng.
A British gentleman, dressed in full military uniform, waving his hat with a background of people sitting back and looking out onto the waterway.	Một quý ông người Anh, mặc quân phục đầy đủ, vẫy cái nón của mình với một bối cảnh của những người ngồi sau lưng và nhìn ra đường nước.	Một quý ông người Anh, mặc quân phục, đang vẫy mũ, phía sau là những người đang ngồi và nhìn ra đường thủy.
Two cars are driving on a racetrack.	Có 2 xe đang đua trên đường đua.	Hai chiếc xe đang chạy trên đường đua.
A man in a black and white jersey is holding yellow ski poles and preparing to take off.	Một người đàn ông mặc áo lót đen trắng đang giữ những tấm ván trượt màu vàng và chuẩn bị cất cánh.	Một người đàn ông mặc áo len đen trắng đang cầm gậy trượt tuyết màu vàng và chuẩn bị cất cánh.
Two people are laying down and kissing on a grassy lawn.	Hai người đang nằm xuống và hôn nhau trên bãi cỏ.	Hai người đang nằm và hôn nhau trên bãi cỏ.
A very young child in a denim baseball cap eats a green apple.	Một đứa trẻ đeo nón bóng chày rất trẻ tuổi sẽ ăn một quả táo xanh.	Một đứa trẻ rất nhỏ đội mũ bóng chày bằng vải denim đang ăn một quả táo xanh.
The football players are running to get the ball.	Các cầu thủ bóng bầu dục đang chuẩn bị để có bóng.	Các cầu thủ bóng đá đang chạy để giành bóng.
A man in a black jacket and checkered hat wearing black and white striped pants plays an electric guitar on a stage with a singer and another guitar player in the background.	Một người đàn ông mặc áo khoác đen và đội mũ cao bồi mặc quần đen và trắng sọc, chơi một phát ghi-ta trên sân khấu với một ca sĩ và một nhạc sĩ guitar khác trong nền.	Một người đàn ông mặc áo khoác đen, đội mũ kẻ caro, mặc quần sọc đen trắng đang chơi đàn guitar điện trên sân khấu, trong khi một ca sĩ và một nghệ sĩ guitar khác chơi ở phía sau.
A man is leaping over a barrier away from a bull.	Một người đàn ông đang đi trên một hàng rào cách xa một con bò.	Một người đàn ông đang nhảy qua rào chắn để tránh xa một con bò đực.
A woman in a blue shirt and white shorts playing tennis.	Một người phụ nữ mặc áo sơ mi xanh và quần shorts trắng đang chơi tennis.	Một người phụ nữ mặc áo sơ mi xanh và quần short trắng đang chơi quần vợt.
A man is playing an interment in a concert	♪ Một người đàn ông đang chơi một người đàn ông đóng kịch trong một hòa nhạc ♪	Một người đàn ông đang chơi đàn trong một buổi hòa nhạc
A man is carrying a large load of metal beams on his shoulder through a lumberyard.	Một người đàn ông đang mang một đống kim loại nặng trên vai qua một tấm gỗ.	Một người đàn ông đang vác một khối gỗ lớn trên vai qua một xưởng gỗ.
Woman with camera is throwing a Frisbee for her brown dog to catch.	Phụ nữ với máy ảnh là ném một con ong con cho con chó nâu của mình để bắt.	Người phụ nữ cầm máy ảnh đang ném một chiếc đĩa Frisbee để chú chó nâu của mình bắt lấy.
There is an outline of a male and female observing a bonfire or other large burning wooden object.	Có một dãy đàn ông và cái nhìn thấy một hoặc nhiều vật thể lớn khác đang đốt.	Có hình ảnh phác họa một người đàn ông và một người phụ nữ đang quan sát đống lửa trại hoặc một vật thể gỗ lớn đang cháy.
Two girls dipping their hands in a fountain as people walk by.	Hai cô gái nhúng tay vào cái vòi nước khi mọi người đi qua.	Hai cô gái nhúng tay vào đài phun nước khi mọi người đi ngang qua.
A wet, smiling child without a shirt poses with arms raised.	Một đứa trẻ ướt, mỉm cười mà không có một cái áo sơ mi với đôi tay giơ lên.	Một đứa trẻ ướt sũng, không mặc áo, đang tạo dáng với hai tay giơ lên.
Two men, one wearing white and the other wearing blue, are wrestling.	Hai người đàn ông, một người mặc đồ trắng và người kia mặc màu xanh, đang đấu vật.	Hai người đàn ông, một người mặc đồ trắng và người kia mặc đồ xanh, đang vật lộn.
A woman in a red bikini jumping to hit a ball while playing volleyball at a beach.	Một người phụ nữ mặc đồng phục màu đỏ nhảy vào một trận bóng trong khi đang chơi bóng tại bãi biển.	Một người phụ nữ mặc bộ bikini màu đỏ đang nhảy đánh bóng khi chơi bóng chuyền trên bãi biển.
Orange striped kitten biting blond girl on the nose	♪ Cô gái tóc vàng trên mũi ♪	Mèo con sọc cam cắn vào mũi cô gái tóc vàng
A woman, wearing a yellow apron, is taking the lid off of a large pot.	Một phụ nữ, mặc áo choàng màu vàng, đang tháo nắp nồi lớn.	Một người phụ nữ mặc tạp dề màu vàng đang mở nắp một chiếc nồi lớn.
Two children cross a small brook using a stone bridge.	Hai người vượt qua một khe nhỏ bằng đá.	Hai đứa trẻ băng qua một con suối nhỏ bằng cây cầu đá.
Two African american females ride on a moped down a city street that appears to be in a well congested area of a large city area.	Hai người đàn bà Phi Châu đi trên một chiếc xe phế thải trên một con đường có vẻ như nằm trong một khu vực đông đúc của một thành phố lớn.	Hai người phụ nữ Mỹ gốc Phi đi xe máy trên một con phố có vẻ như nằm trong khu vực đông đúc của một thành phố lớn.
Two boys in front of a soda machine.	Hai cậu bé đứng trước một cái máy.	Hai cậu bé đứng trước máy bán nước ngọt.
Bicycle rider wearing black, riding down a dirt trail in a mountain bike.	Một người đi xe đạp màu đen, đi dọc theo một con đường mòn trên một chiếc xe đạp.	Người đi xe đạp mặc đồ đen, đang đạp xe leo núi trên đường mòn đất.
A lady with tattoos is taking a picture of a painting with her smartphone.	Một người phụ nữ với hình xăm đang chụp một bức tranh với...	Một phụ nữ có hình xăm đang chụp ảnh một bức tranh bằng điện thoại thông minh của mình.
A woman in a mostly black outfit and white helmet riding a bike with blurred trees in the background.	Một phụ nữ mặc đồ đen và đội mũ trắng đội một chiếc xe đạp với những cái cây xấu xí phía sau.	Một người phụ nữ mặc trang phục chủ yếu là màu đen và đội mũ bảo hiểm màu trắng đang đạp xe với những hàng cây mờ ảo ở phía sau.
A team of cyclists rounds a bend while nearby spectators cheer and take photographs.	Một nhóm nhân viên tuần tra đi vòng quanh một khúc quanh trong khi gần đó cổ vũ và chụp ảnh.	Một đội xe đạp vòng qua một khúc cua trong khi khán giả gần đó cổ vũ và chụp ảnh.
Four football players in black are tackling the opposing team's player, shown in white, while it is raining.	4 cầu thủ bóng bầu dục đen đang tranh giành cầu thủ bóng chày của đội bóng đối lập, thể hiện trong trắng, trong khi trời đang mưa.	Bốn cầu thủ bóng đá mặc đồ đen đang tranh bóng với cầu thủ của đội đối phương, được thể hiện mặc đồ trắng, trong khi trời đang mưa.
A runner scrambles for yardage while being brought down by two tacklers.	Một vận động viên chạy bộ trong khi bị hạ bởi hai đối thủ.	Một vận động viên chạy đua giành yardage trong khi bị hai cầu thủ truy cản.
The basketball player in the white uniform with the number 55 on it is guarding the player in the black uniform with the number 10 on it.	Người chơi bóng trong đồng phục trắng với số 55 trên đó là bảo vệ người chơi trong đồng phục màu đen với số 10 trên đó.	Cầu thủ bóng rổ mặc đồng phục màu trắng có số 55 đang bảo vệ cầu thủ mặc đồng phục màu đen có số 10.
A man is talking on a cellphone outside.	Một người đàn ông đang nói chuyện trên một bên ngoài.	Một người đàn ông đang nói chuyện điện thoại di động ở bên ngoài.
Professional baseball players during the All Star game watch an opponent at bat.	Cầu thủ bóng chày trong trò chơi All Star xem một đối thủ bóng chày.	Các cầu thủ bóng chày chuyên nghiệp trong trận đấu All Star theo dõi đối thủ đánh bóng.
Dirt biker makes a sloping turn in a forest during the fall.	Máy đạp làm một cú rẽ vào một khu rừng trong mùa thu.	Người đi xe địa hình rẽ dốc trong rừng vào mùa thu.
3 basketball players vying for the ball and one in red jersey trying to take ball from guy in white jersey.	3 cầu thủ bóng rổ giành bóng cho trận đấu và 1 người mặc áo đỏ đang cố gắng để nhận bóng từ một gã mặc quần áo trắng.	3 cầu thủ bóng rổ đang tranh bóng và một người mặc áo đỏ đang cố gắng lấy bóng từ anh chàng mặc áo trắng.
A boy grabs his leg as he jumps in the air.	Một cậu bé nắm lấy chân khi nhảy lên trời.	Một cậu bé nắm lấy chân mình khi nhảy lên không trung.
Two children wearing striped sweaters and black pants tussle outdoors near a play set.	Hai đứa trẻ mặc áo len sọc và quần lót đen gần một sân chơi.	Hai đứa trẻ mặc áo len sọc và quần đen đang vật lộn ngoài trời gần một khu vui chơi.
A man wearing sunglasses is riding a scooter.	Một người đàn ông mặc đồ bảo hộ là một người đàn ông.	Một người đàn ông đeo kính râm đang đi xe tay ga.
A small boy wearing baseball regalia holds a bat behind his head with a baseball mounted in front of him.	Một cậu bé đeo bóng chày bóng chày đeo một cây gậy sau đầu với một cái bóng chày trước mặt.	Một cậu bé mặc đồ bóng chày đang cầm một cây gậy bóng chày sau đầu với một quả bóng chày gắn ở phía trước.
Six men sit in a field of crops containing wooden crates.	Sáu người đàn ông ngồi trong một cánh đồng gỗ.	Sáu người đàn ông ngồi trên một cánh đồng trồng trọt chứa những thùng gỗ.
A brown dog picks up a twig from a stone surface.	Một con chó nâu nhặt một cành cây từ một tảng đá.	Một con chó nâu đang nhặt một cành cây từ bề mặt đá.
This is a man dressed in yellow holding the reign of a brown horse	Đây là một người đàn ông mặc màu vàng đang nắm giữ vương triều của một con ngựa	Đây là một người đàn ông mặc đồ vàng đang cầm cương một con ngựa nâu
A man in a white shirt and apron cuts up a bird.	Một người mặc áo sơ mi trắng và cắt một con chim.	Một người đàn ông mặc áo sơ mi trắng và tạp dề đang cắt thịt một con chim.
A hispanic woman is using a outdoors wok to cook.	Một người phụ nữ âm đạo của ông đang sử dụng đồng xu để nấu ăn.	Một phụ nữ gốc Tây Ban Nha đang sử dụng chảo ngoài trời để nấu ăn.
Marathon runners are racing on a city street, with other people standing around.	Những người chạy đua đang chạy đua trên đường phố, với những người khác đứng xung quanh.	Những người chạy marathon đang chạy trên đường phố thành phố, xung quanh có nhiều người đứng xem.
Asian woman wearing a sunhat while riding a bike.	Một phụ nữ đàn bà đàn bà đeo mặt trời khi đang đi xe đạp.	Người phụ nữ châu Á đội mũ che nắng khi đi xe đạp.
Some children are outside playing in the dirt where two trees are.	Một vài đứa trẻ đang chơi đùa ở ngoài nơi có 2 cây.	Một số trẻ em đang chơi ở ngoài đất, nơi có hai cái cây.
An older man is playing a video arcade game.	Một người đàn ông lớn tuổi đang chơi một trò chơi điện tử.	Một người đàn ông lớn tuổi đang chơi trò chơi điện tử.
A girl at the shore of a beach with a mountain in the distance.	Một cô gái trên bờ biển với một ngọn núi ở xa.	Một cô gái ở bờ biển với ngọn núi ở đằng xa.
